år	sb.itk.sg.ubest
dag	sb.fk.sg.ubest
krone	sb.fk.sg.ubest
gang	sb.fk.sg.ubest
tid	sb.fk.sg.ubest
sted	sb.itk.sg.ubest
land	sb.itk.sg.ubest
barn	sb.itk.sg.ubest
procent	sb.fk.sg.ubest
mand	sb.fk.sg.ubest
del	sb.fk.sg.ubest
kommune	sb.fk.sg.ubest
menneske	sb.itk.sg.ubest
replik	sb.fk.sg.ubest
sag	sb.fk.sg.ubest
regering	sb.fk.sg.ubest
eksempel	sb.itk.sg.ubest
verden	sb.fk.sg.ubest
folk	sb.itk.sg.ubest
problem	sb.itk.sg.ubest
side	sb.fk.sg.ubest
uge	sb.fk.sg.ubest
vej	sb.fk.sg.ubest
minut	sb.itk.sg.ubest
kamp	sb.fk.sg.ubest
kvinde	sb.fk.sg.ubest
liv	sb.itk.sg.ubest
virksomhed	sb.fk.sg.ubest
by	sb.fk.sg.ubest
forhold	sb.itk.sg.ubest
måde	sb.fk.sg.ubest
mulighed	sb.fk.sg.ubest
arbejde	sb.itk.sg.ubest
grund	sb.fk.sg.ubest
politi	sb.itk.sg.ubest
bog	sb.fk.sg.ubest
område	sb.itk.sg.ubest
måned	sb.fk.sg.ubest
par	sb.itk.sg.ubest
række	sb.fk.sg.ubest
skole	sb.fk.sg.ubest
plads	sb.fk.sg.ubest
familie	sb.fk.sg.ubest
klokke	sb.fk.sg.ubest
million	sb.fk.sg.ubest
pris	sb.fk.sg.ubest
historie	sb.fk.sg.ubest
ting	sb.fk.sg.ubest
bil	sb.fk.sg.ubest
film	sb.fk.sg.ubest
hus	sb.itk.sg.ubest
formand	sb.fk.sg.ubest
direktør	sb.fk.sg.ubest
aften	sb.fk.sg.ubest
parti	sb.itk.sg.ubest
spørgsmål	sb.itk.sg.ubest
medlem	sb.itk.sg.ubest
jeg	sb.itk.sg.ubest
dansker	sb.fk.sg.ubest
hold	sb.itk.sg.ubest
selskab	sb.itk.sg.ubest
fald	sb.itk.sg.ubest
gruppe	sb.fk.sg.ubest
lov	sb.fk.sg.ubest
billede	sb.itk.sg.ubest
mål	sb.itk.sg.ubest
ord	sb.itk.sg.ubest
time	sb.fk.sg.ubest
politiker	sb.fk.sg.ubest
brug	sb.fk.sg.ubest
bank	sb.fk.sg.ubest
person	sb.fk.sg.ubest
udvikling	sb.fk.sg.ubest
resultat	sb.itk.sg.ubest
leder	sb.fk.sg.ubest
forbindelse	sb.fk.sg.ubest
navn	sb.itk.sg.ubest
løb	sb.itk.sg.ubest
form	sb.fk.sg.ubest
grad	sb.fk.sg.ubest
projekt	sb.itk.sg.ubest
samfund	sb.itk.sg.ubest
møde	sb.itk.sg.ubest
situation	sb.fk.sg.ubest
plan	sb.fk.sg.ubest
hånd	sb.fk.sg.ubest
universitet	sb.itk.sg.ubest
avis	sb.fk.sg.ubest
valg	sb.itk.sg.ubest
opgave	sb.fk.sg.ubest
tal	sb.itk.sg.ubest
slags	sb.fk.sg.ubest
klub	sb.fk.sg.ubest
stat	sb.fk.sg.ubest
morgen	sb.fk.sg.ubest
tekst	sb.fk.sg.ubest
forælder	sb.fk.sg.ubest
ret	sb.fk.sg.ubest
undersøgelse	sb.fk.sg.ubest
antal	sb.itk.sg.ubest
fremtid	sb.fk.sg.ubest
aftale	sb.fk.sg.ubest
krav	sb.itk.sg.ubest
øje	sb.itk.sg.ubest
præsident	sb.fk.sg.ubest
samarbejde	sb.itk.sg.ubest
forslag	sb.itk.sg.ubest
musik	sb.fk.sg.ubest
søndag	sb.fk.sg.ubest
medarbejder	sb.fk.sg.ubest
pige	sb.fk.sg.ubest
tilfælde	sb.itk.sg.ubest
elev	sb.fk.sg.ubest
marked	sb.itk.sg.ubest
lørdag	sb.fk.sg.ubest
mor	sb.fk.sg.ubest
kirke	sb.fk.sg.ubest
kunde	sb.fk.sg.ubest
periode	sb.fk.sg.ubest
borger	sb.fk.sg.ubest
masse	sb.fk.sg.ubest
ja	sb.itk.sg.ubest
uddannelse	sb.fk.sg.ubest
fredag	sb.fk.sg.ubest
ven	sb.fk.sg.ubest
job	sb.itk.sg.ubest
krig	sb.fk.sg.ubest
vand	sb.itk.sg.ubest
nummer	sb.itk.sg.ubest
interesse	sb.fk.sg.ubest
økonomi	sb.fk.sg.ubest
spil	sb.itk.sg.ubest
hjælp	sb.fk.sg.ubest
kilometer	sb.fk.sg.ubest
rolle	sb.fk.sg.ubest
øjeblik	sb.itk.sg.ubest
gengæld	sb.fk.sg.ubest
tur	sb.fk.sg.ubest
politik	sb.fk.sg.ubest
tidspunkt	sb.itk.sg.ubest
debat	sb.fk.sg.ubest
meter	sb.fk.sg.ubest
ansvar	sb.itk.sg.ubest
stykke	sb.itk.sg.ubest
forfatter	sb.fk.sg.ubest
tale	sb.fk.sg.ubest
system	sb.itk.sg.ubest
dreng	sb.fk.sg.ubest
huskeregel	sb.fk.sg.ubest
løsning	sb.fk.sg.ubest
mandag	sb.fk.sg.ubest
torsdag	sb.fk.sg.ubest
tvivl	sb.fk.sg.ubest
ledelse	sb.fk.sg.ubest
sæson	sb.fk.sg.ubest
virkelighed	sb.fk.sg.ubest
teater	sb.itk.sg.ubest
beslutning	sb.fk.sg.ubest
spiller	sb.fk.sg.ubest
læge	sb.fk.sg.ubest
skat	sb.fk.sg.ubest
rest	sb.fk.sg.ubest
kraft	sb.fk.sg.ubest
lejlighed	sb.fk.sg.ubest
aktie	sb.fk.sg.ubest
medie	sb.itk.sg.ubest
sejr	sb.fk.sg.ubest
baggrund	sb.fk.sg.ubest
program	sb.itk.sg.ubest
sommer	sb.fk.sg.ubest
grænse	sb.fk.sg.ubest
svar	sb.itk.sg.ubest
onsdag	sb.fk.sg.ubest
råd	sb.itk.sg.ubest
indsats	sb.fk.sg.ubest
firma	sb.itk.sg.ubest
bestyrelse	sb.fk.sg.ubest
hoved	sb.itk.sg.ubest
søn	sb.fk.sg.ubest
befolkning	sb.fk.sg.ubest
januar	sb.fk.sg.ubest
forsøg	sb.itk.sg.ubest
patient	sb.fk.sg.ubest
mening	sb.fk.sg.ubest
folketing	sb.itk.sg.ubest
forening	sb.fk.sg.ubest
nat	sb.fk.sg.ubest
start	sb.fk.sg.ubest
salg	sb.itk.sg.ubest
tirsdag	sb.fk.sg.ubest
lys	sb.itk.sg.ubest
pause	sb.fk.sg.ubest
museum	sb.itk.sg.ubest
organisation	sb.fk.sg.ubest
stilling	sb.fk.sg.ubest
værdi	sb.fk.sg.ubest
stemme	sb.fk.sg.ubest
oplysning	sb.fk.sg.ubest
hjem	sb.itk.sg.ubest
minister	sb.fk.sg.ubest
forskel	sb.fk.sg.ubest
scene	sb.fk.sg.ubest
mad	sb.fk.sg.ubest
nej	sb.itk.sg.ubest
unge	sb.fk.sg.ubest
september	sb.fk.sg.ubest
journalist	sb.fk.sg.ubest
kunst	sb.fk.sg.ubest
død	sb.fk.sg.ubest
behandling	sb.fk.sg.ubest
udtryk	sb.itk.sg.ubest
jord	sb.fk.sg.ubest
professor	sb.fk.sg.ubest
maj	sb.fk.sg.ubest
bane	sb.fk.sg.ubest
milliard	sb.fk.sg.ubest
klasse	sb.fk.sg.ubest
niveau	sb.itk.sg.ubest
udstilling	sb.fk.sg.ubest
værk	sb.itk.sg.ubest
vækst	sb.fk.sg.ubest
afdeling	sb.fk.sg.ubest
succes	sb.fk.sg.ubest
ende	sb.fk.sg.ubest
myndighed	sb.fk.sg.ubest
rapport	sb.fk.sg.ubest
telefon	sb.fk.sg.ubest
bord	sb.itk.sg.ubest
magt	sb.fk.sg.ubest
chef	sb.fk.sg.ubest
marts	sb.fk.sg.ubest
region	sb.fk.sg.ubest
chance	sb.fk.sg.ubest
butik	sb.fk.sg.ubest
november	sb.fk.sg.ubest
serie	sb.fk.sg.ubest
kritik	sb.fk.sg.ubest
gæst	sb.fk.sg.ubest
fokus	sb.fk.sg.ubest
december	sb.fk.sg.ubest
oplevelse	sb.fk.sg.ubest
dør	sb.fk.sg.ubest
kultur	sb.fk.sg.ubest
post	sb.fk.sg.ubest
konsekvens	sb.fk.sg.ubest
soldat	sb.fk.sg.ubest
årsag	sb.fk.sg.ubest
juni	sb.fk.sg.ubest
erfaring	sb.fk.sg.ubest
april	sb.fk.sg.ubest
blad	sb.itk.sg.ubest
betydning	sb.fk.sg.ubest
fodbold	sb.fk.sg.ubest
statsminister	sb.fk.sg.ubest
besøg	sb.itk.sg.ubest
fordel	sb.fk.sg.ubest
oktober	sb.fk.sg.ubest
kunstner	sb.fk.sg.ubest
ønske	sb.itk.sg.ubest
støtte	sb.fk.sg.ubest
begyndelse	sb.fk.sg.ubest
model	sb.fk.sg.ubest
kurs	sb.fk.sg.ubest
fejl	sb.fk.sg.ubest
gade	sb.fk.sg.ubest
risiko	sb.fk.sg.ubest
holdning	sb.fk.sg.ubest
natur	sb.fk.sg.ubest
produkt	sb.itk.sg.ubest
bygning	sb.fk.sg.ubest
datter	sb.fk.sg.ubest
koncert	sb.fk.sg.ubest
kvalitet	sb.fk.sg.ubest
borgmester	sb.fk.sg.ubest
artikel	sb.fk.sg.ubest
kontakt	sb.fk.sg.ubest
point	sb.itk.sg.ubest
konkurrence	sb.fk.sg.ubest
kollega	sb.fk.sg.ubest
flertal	sb.itk.sg.ubest
dollar	sb.fk.sg.ubest
lyst	sb.fk.sg.ubest
center	sb.itk.sg.ubest
sprog	sb.itk.sg.ubest
stand	sb.fk.sg.ubest
sang	sb.fk.sg.ubest
weekend	sb.fk.sg.ubest
aktivitet	sb.fk.sg.ubest
dyr	sb.itk.sg.ubest
fængsel	sb.itk.sg.ubest
sygdom	sb.fk.sg.ubest
tilbud	sb.itk.sg.ubest
krop	sb.fk.sg.ubest
hensyn	sb.itk.sg.ubest
publikum	sb.itk.sg.ubest
omgang	sb.fk.sg.ubest
adgang	sb.fk.sg.ubest
skyld	sb.fk.sg.ubest
forsker	sb.fk.sg.ubest
herre	sb.fk.sg.ubest
udfordring	sb.fk.sg.ubest
februar	sb.fk.sg.ubest
karriere	sb.fk.sg.ubest
bolig	sb.fk.sg.ubest
top	sb.fk.sg.ubest
stjerne	sb.fk.sg.ubest
forklaring	sb.fk.sg.ubest
august	sb.fk.sg.ubest
socialdemokrat	sb.fk.sg.ubest
roman	sb.fk.sg.ubest
alvor	sb.fk.sg.ubest
halvdel	sb.fk.sg.ubest
forhandling	sb.fk.sg.ubest
kone	sb.fk.sg.ubest
rejse	sb.fk.sg.ubest
titel	sb.fk.sg.ubest
tanke	sb.fk.sg.ubest
viden	sb.fk.sg.ubest
forestilling	sb.fk.sg.ubest
produktion	sb.fk.sg.ubest
juli	sb.fk.sg.ubest
idé	sb.fk.sg.ubest
sikkerhed	sb.fk.sg.ubest
miljø	sb.itk.sg.ubest
forår	sb.itk.sg.ubest
forventning	sb.fk.sg.ubest
formål	sb.itk.sg.ubest
mine	sb.fk.sg.ubest
rum	sb.itk.sg.ubest
skade	sb.fk.sg.ubest
ben	sb.itk.sg.ubest
efterår	sb.itk.sg.ubest
styrke	sb.fk.sg.ubest
type	sb.fk.sg.ubest
hovedstad	sb.fk.sg.ubest
institution	sb.fk.sg.ubest
sammenhæng	sb.fk.sg.ubest
stof	sb.itk.sg.ubest
udvalg	sb.itk.sg.ubest
retning	sb.fk.sg.ubest
udland	sb.itk.sg.ubest
forretning	sb.fk.sg.ubest
alder	sb.fk.sg.ubest
vælger	sb.fk.sg.ubest
emne	sb.itk.sg.ubest
dommer	sb.fk.sg.ubest
behov	sb.itk.sg.ubest
kilde	sb.fk.sg.ubest
pres	sb.itk.sg.ubest
information	sb.fk.sg.ubest
sygehus	sb.itk.sg.ubest
læser	sb.fk.sg.ubest
brev	sb.itk.sg.ubest
skuespiller	sb.fk.sg.ubest
studerende	sb.fk.sg.ubest
arbejdsplads	sb.fk.sg.ubest
luft	sb.fk.sg.ubest
tag	sb.itk.sg.ubest
eftermiddag	sb.fk.sg.ubest
evne	sb.fk.sg.ubest
gud	sb.fk.sg.ubest
konflikt	sb.fk.sg.ubest
investering	sb.fk.sg.ubest
venstre	sb.itk.sg.ubest
energi	sb.fk.sg.ubest
advokat	sb.fk.sg.ubest
forskning	sb.fk.sg.ubest
ekspert	sb.fk.sg.ubest
demokrati	sb.itk.sg.ubest
slutning	sb.fk.sg.ubest
udgangspunkt	sb.itk.sg.ubest
udsigt	sb.fk.sg.ubest
middel	sb.itk.sg.ubest
kommission	sb.fk.sg.ubest
dom	sb.fk.sg.ubest
restaurant	sb.fk.sg.ubest
effekt	sb.fk.sg.ubest
amt	sb.itk.sg.ubest
overskud	sb.itk.sg.ubest
vare	sb.fk.sg.ubest
vin	sb.fk.sg.ubest
kærlighed	sb.fk.sg.ubest
foto	sb.itk.sg.ubest
hjerte	sb.itk.sg.ubest
følelse	sb.fk.sg.ubest
ejer	sb.fk.sg.ubest
træ	sb.itk.sg.ubest
forsvar	sb.itk.sg.ubest
angreb	sb.itk.sg.ubest
følge	sb.fk.sg.ubest
deltager	sb.fk.sg.ubest
have	sb.fk.sg.ubest
arrangement	sb.itk.sg.ubest
stigning	sb.fk.sg.ubest
vold	sb.fk.sg.ubest
trods	sb.fk.sg.ubest
tradition	sb.fk.sg.ubest
ændring	sb.fk.sg.ubest
ejendom	sb.fk.sg.ubest
generation	sb.fk.sg.ubest
udgift	sb.fk.sg.ubest
farve	sb.fk.sg.ubest
lære	sb.fk.sg.ubest
investor	sb.fk.sg.ubest
drøm	sb.fk.sg.ubest
diskussion	sb.fk.sg.ubest
ramme	sb.fk.sg.ubest
initiativ	sb.itk.sg.ubest
kontrol	sb.fk.sg.ubest
glæde	sb.fk.sg.ubest
flygtning	sb.fk.sg.ubest
indflydelse	sb.fk.sg.ubest
størrelse	sb.fk.sg.ubest
hund	sb.fk.sg.ubest
stil	sb.fk.sg.ubest
vurdering	sb.fk.sg.ubest
fly	sb.itk.sg.ubest
modstander	sb.fk.sg.ubest
fond	sb.fk.sg.ubest
bibliotek	sb.itk.sg.ubest
kommentar	sb.fk.sg.ubest
vejr	sb.itk.sg.ubest
hotel	sb.itk.sg.ubest
hjemmeside	sb.fk.sg.ubest
ansigt	sb.itk.sg.ubest
amerikaner	sb.fk.sg.ubest
beboer	sb.fk.sg.ubest
lærer	sb.fk.sg.ubest
havn	sb.fk.sg.ubest
euro	sb.fk.sg.ubest
spor	sb.itk.sg.ubest
institut	sb.itk.sg.ubest
karakter	sb.fk.sg.ubest
regnskab	sb.itk.sg.ubest
proces	sb.fk.sg.ubest
part	sb.fk.sg.ubest
kandidat	sb.fk.sg.ubest
kontrakt	sb.fk.sg.ubest
opfattelse	sb.fk.sg.ubest
arbejdsmarked	sb.itk.sg.ubest
forbruger	sb.fk.sg.ubest
analyse	sb.fk.sg.ubest
sport	sb.fk.sg.ubest
bund	sb.fk.sg.ubest
fest	sb.fk.sg.ubest
net	sb.itk.sg.ubest
studie	sb.itk.sg.ubest
bevægelse	sb.fk.sg.ubest
løn	sb.fk.sg.ubest
rente	sb.fk.sg.ubest
orden	sb.fk.sg.ubest
hverdag	sb.fk.sg.ubest
omsætning	sb.fk.sg.ubest
skridt	sb.itk.sg.ubest
tøj	sb.itk.sg.ubest
udgave	sb.fk.sg.ubest
materiale	sb.itk.sg.ubest
jul	sb.fk.sg.ubest
nyhed	sb.fk.sg.ubest
undervisning	sb.fk.sg.ubest
fod	sb.fk.sg.ubest
bud	sb.itk.sg.ubest
mangel	sb.fk.sg.ubest
træner	sb.fk.sg.ubest
erhvervsliv	sb.itk.sg.ubest
frihed	sb.fk.sg.ubest
koncern	sb.fk.sg.ubest
tak	sb.fk.sg.ubest
handling	sb.fk.sg.ubest
håb	sb.itk.sg.ubest
linje	sb.fk.sg.ubest
tendens	sb.fk.sg.ubest
kontor	sb.itk.sg.ubest
anledning	sb.fk.sg.ubest
station	sb.fk.sg.ubest
industri	sb.fk.sg.ubest
presse	sb.fk.sg.ubest
budget	sb.itk.sg.ubest
skib	sb.itk.sg.ubest
computer	sb.fk.sg.ubest
branche	sb.fk.sg.ubest
kæreste	sb.fk.sg.ubest
handel	sb.fk.sg.ubest
internet	sb.itk.sg.ubest
grundlag	sb.itk.sg.ubest
sol	sb.fk.sg.ubest
hav	sb.itk.sg.ubest
parlament	sb.itk.sg.ubest
trussel	sb.fk.sg.ubest
slag	sb.itk.sg.ubest
køb	sb.itk.sg.ubest
byråd	sb.itk.sg.ubest
regel	sb.fk.sg.ubest
billet	sb.fk.sg.ubest
byggeri	sb.itk.sg.ubest
træk	sb.fk.sg.ubest
tog	sb.itk.sg.ubest
samtale	sb.fk.sg.ubest
indhold	sb.itk.sg.ubest
princip	sb.itk.sg.ubest
mængde	sb.fk.sg.ubest
interview	sb.itk.sg.ubest
stemning	sb.fk.sg.ubest
forlag	sb.itk.sg.ubest
folkeskole	sb.fk.sg.ubest
tro	sb.fk.sg.ubest
kasse	sb.fk.sg.ubest
vægt	sb.fk.sg.ubest
spids	sb.fk.sg.ubest
hospital	sb.itk.sg.ubest
respekt	sb.fk.sg.ubest
bus	sb.fk.sg.ubest
omfang	sb.itk.sg.ubest
ferie	sb.fk.sg.ubest
fællesskab	sb.itk.sg.ubest
papir	sb.itk.sg.ubest
afstand	sb.fk.sg.ubest
fred	sb.fk.sg.ubest
praksis	sb.fk.sg.ubest
liter	sb.fk.sg.ubest
køkken	sb.itk.sg.ubest
punkt	sb.itk.sg.ubest
opmærksomhed	sb.fk.sg.ubest
krise	sb.fk.sg.ubest
beløb	sb.itk.sg.ubest
fortid	sb.fk.sg.ubest
instruktør	sb.fk.sg.ubest
afgørelse	sb.fk.sg.ubest
lån	sb.itk.sg.ubest
turnering	sb.fk.sg.ubest
begivenhed	sb.fk.sg.ubest
kris	sb.fk.sg.ubest
lufthavn	sb.fk.sg.ubest
strategi	sb.fk.sg.ubest
hest	sb.fk.sg.ubest
offer	sb.itk.sg.ubest
finale	sb.fk.sg.ubest
nabo	sb.fk.sg.ubest
muslim	sb.fk.sg.ubest
brand	sb.itk.sg.ubest
præst	sb.fk.sg.ubest
trafik	sb.fk.sg.ubest
ro	sb.fk.sg.ubest
opgør	sb.itk.sg.ubest
reform	sb.fk.sg.ubest
ordning	sb.fk.sg.ubest
vindue	sb.itk.sg.ubest
landbrug	sb.itk.sg.ubest
udenrigsminister	sb.fk.sg.ubest
tab	sb.itk.sg.ubest
centimeter	sb.fk.sg.ubest
øre	sb.itk.sg.ubest
modsætning	sb.fk.sg.ubest
indtryk	sb.itk.sg.ubest
bold	sb.fk.sg.ubest
personale	sb.itk.sg.ubest
vilje	sb.fk.sg.ubest
tegn	sb.itk.sg.ubest
nederlag	sb.itk.sg.ubest
metode	sb.fk.sg.ubest
sekund	sb.fk.sg.ubest
hul	sb.itk.sg.ubest
kanal	sb.fk.sg.ubest
dronning	sb.fk.sg.ubest
kaffe	sb.fk.sg.ubest
arm	sb.fk.sg.ubest
sandhed	sb.fk.sg.ubest
løkke	sb.fk.sg.ubest
socialdemokrati	sb.itk.sg.ubest
lyd	sb.fk.sg.ubest
skov	sb.fk.sg.ubest
bro	sb.fk.sg.ubest
frygt	sb.fk.sg.ubest
forståelse	sb.fk.sg.ubest
fortælling	sb.fk.sg.ubest
kort	sb.itk.sg.ubest
hal	sb.fk.sg.ubest
ryg	sb.fk.sg.ubest
ring	sb.itk.sg.ubest
runde	sb.fk.sg.ubest
tank	sb.fk.sg.ubest
budskab	sb.itk.sg.ubest
midte	sb.fk.sg.ubest
kvartal	sb.itk.sg.ubest
smag	sb.fk.sg.ubest
årti	sb.itk.sg.ubest
tilskuer	sb.fk.sg.ubest
dialog	sb.fk.sg.ubest
domstol	sb.fk.sg.ubest
felt	sb.itk.sg.ubest
repræsentant	sb.fk.sg.ubest
tillid	sb.fk.sg.ubest
våben	sb.itk.sg.ubest
landshold	sb.itk.sg.ubest
detalje	sb.fk.sg.ubest
konkurrent	sb.fk.sg.ubest
reaktion	sb.fk.sg.ubest
styr	sb.itk.sg.ubest
strand	sb.fk.sg.ubest
festival	sb.fk.sg.ubest
hær	sb.fk.sg.ubest
kvadratmeter	sb.fk.sg.ubest
argument	sb.itk.sg.ubest
talent	sb.itk.sg.ubest
besked	sb.fk.sg.ubest
maleri	sb.itk.sg.ubest
sektor	sb.fk.sg.ubest
båd	sb.fk.sg.ubest
tysker	sb.fk.sg.ubest
pension	sb.fk.sg.ubest
opbakning	sb.fk.sg.ubest
mail	sb.fk.sg.ubest
medicin	sb.fk.sg.ubest
børs	sb.fk.sg.ubest
dame	sb.fk.sg.ubest
omstændighed	sb.fk.sg.ubest
væg	sb.fk.sg.ubest
service	sb.itk.sg.ubest
konge	sb.fk.sg.ubest
nation	sb.fk.sg.ubest
motor	sb.fk.sg.ubest
finger	sb.fk.sg.ubest
musiker	sb.fk.sg.ubest
ressource	sb.fk.sg.ubest
art	sb.fk.sg.ubest
øl	sb.fk.sg.ubest
smule	sb.fk.sg.ubest
arkitekt	sb.fk.sg.ubest
blik	sb.itk.sg.ubest
alliance	sb.fk.sg.ubest
vedkommende	sb.itk.sg.ubest
arbejdsgiver	sb.fk.sg.ubest
teknologi	sb.fk.sg.ubest
kampagne	sb.fk.sg.ubest
partner	sb.fk.sg.ubest
lokale	sb.itk.sg.ubest
tema	sb.itk.sg.ubest
fag	sb.itk.sg.ubest
udtalelse	sb.fk.sg.ubest
religion	sb.fk.sg.ubest
vis	sb.fk.sg.ubest
sigt	sb.fk.sg.ubest
vilkår	sb.itk.sg.ubest
park	sb.fk.sg.ubest
fisk	sb.fk.sg.ubest
lovgivning	sb.fk.sg.ubest
indvandrer	sb.fk.sg.ubest
højde	sb.fk.sg.ubest
landsby	sb.fk.sg.ubest
statistik	sb.fk.sg.ubest
tone	sb.fk.sg.ubest
træning	sb.fk.sg.ubest
turist	sb.fk.sg.ubest
forbrug	sb.itk.sg.ubest
sal	sb.fk.sg.ubest
samling	sb.fk.sg.ubest
ulykke	sb.fk.sg.ubest
element	sb.itk.sg.ubest
besparelse	sb.fk.sg.ubest
dagsorden	sb.fk.sg.ubest
synspunkt	sb.itk.sg.ubest
kød	sb.itk.sg.ubest
olie	sb.fk.sg.ubest
gulv	sb.itk.sg.ubest
hår	sb.itk.sg.ubest
jagt	sb.fk.sg.ubest
snak	sb.fk.sg.ubest
indbygger	sb.fk.sg.ubest
netværk	sb.itk.sg.ubest
gram	sb.itk.sg.ubest
centrum	sb.itk.sg.ubest
syn	sb.itk.sg.ubest
mund	sb.fk.sg.ubest
valgkamp	sb.fk.sg.ubest
radio	sb.fk.sg.ubest
vinter	sb.fk.sg.ubest
litteratur	sb.fk.sg.ubest
glas	sb.itk.sg.ubest
premierminister	sb.fk.sg.ubest
drift	sb.fk.sg.ubest
offentlighed	sb.fk.sg.ubest
premiere	sb.fk.sg.ubest
halvleg	sb.fk.sg.ubest
operation	sb.fk.sg.ubest
design	sb.fk.sg.ubest
omkostning	sb.fk.sg.ubest
verdenskrig	sb.fk.sg.ubest
rettighed	sb.fk.sg.ubest
tegning	sb.fk.sg.ubest
vært	sb.fk.sg.ubest
led	sb.itk.sg.ubest
tilværelse	sb.fk.sg.ubest
fart	sb.fk.sg.ubest
opera	sb.fk.sg.ubest
seng	sb.fk.sg.ubest
band	sb.itk.sg.ubest
bruger	sb.fk.sg.ubest
album	sb.itk.sg.ubest
kant	sb.fk.sg.ubest
underskud	sb.itk.sg.ubest
cykel	sb.fk.sg.ubest
hjørne	sb.itk.sg.ubest
opposition	sb.fk.sg.ubest
varme	sb.fk.sg.ubest
fornemmelse	sb.fk.sg.ubest
gård	sb.fk.sg.ubest
forhånd	sb.fk.sg.ubest
position	sb.fk.sg.ubest
tilstand	sb.fk.sg.ubest
faktum	sb.itk.sg.ubest
stol	sb.fk.sg.ubest
guld	sb.itk.sg.ubest
fabrik	sb.fk.sg.ubest
ambition	sb.fk.sg.ubest
mester	sb.fk.sg.ubest
brud	sb.fk.sg.ubest
døgn	sb.itk.sg.ubest
signal	sb.itk.sg.ubest
strøm	sb.fk.sg.ubest
fremgang	sb.fk.sg.ubest
placering	sb.fk.sg.ubest
adresse	sb.fk.sg.ubest
afgift	sb.fk.sg.ubest
forudsætning	sb.fk.sg.ubest
andel	sb.fk.sg.ubest
hustru	sb.fk.sg.ubest
generalforsamling	sb.fk.sg.ubest
indlæg	sb.itk.sg.ubest
håndbold	sb.fk.sg.ubest
alternativ	sb.itk.sg.ubest
blod	sb.itk.sg.ubest
bekymring	sb.fk.sg.ubest
list	sb.fk.sg.ubest
show	sb.itk.sg.ubest
plade	sb.fk.sg.ubest
rute	sb.fk.sg.ubest
gennemsnit	sb.itk.sg.ubest
frue	sb.fk.sg.ubest
forstand	sb.fk.sg.ubest
mærke	sb.itk.sg.ubest
konklusion	sb.fk.sg.ubest
passager	sb.fk.sg.ubest
børnehave	sb.fk.sg.ubest
tilskud	sb.itk.sg.ubest
nærhed	sb.fk.sg.ubest
regning	sb.fk.sg.ubest
version	sb.fk.sg.ubest
vidne	sb.itk.sg.ubest
skærm	sb.fk.sg.ubest
melding	sb.fk.sg.ubest
indtægt	sb.fk.sg.ubest
slot	sb.itk.sg.ubest
rod	sb.fk.sg.ubest
figur	sb.fk.sg.ubest
strid	sb.fk.sg.ubest
sten	sb.fk.sg.ubest
status	sb.fk.sg.ubest
maskine	sb.fk.sg.ubest
hjerne	sb.fk.sg.ubest
bilist	sb.fk.sg.ubest
front	sb.fk.sg.ubest
teknik	sb.fk.sg.ubest
lejr	sb.fk.sg.ubest
sex	sb.fk.sg.ubest
værelse	sb.itk.sg.ubest
gæld	sb.fk.sg.ubest
mark	sb.fk.sg.ubest
dagblad	sb.itk.sg.ubest
forløb	sb.itk.sg.ubest
takt	sb.fk.sg.ubest
formiddag	sb.fk.sg.ubest
rådighed	sb.fk.sg.ubest
lektor	sb.fk.sg.ubest
modstand	sb.fk.sg.ubest
gave	sb.fk.sg.ubest
aktion	sb.fk.sg.ubest
forandring	sb.fk.sg.ubest
bevis	sb.itk.sg.ubest
gevinst	sb.fk.sg.ubest
held	sb.itk.sg.ubest
lovforslag	sb.itk.sg.ubest
kvarter	sb.itk.sg.ubest
betjent	sb.fk.sg.ubest
sygeplejerske	sb.fk.sg.ubest
arbejdskraft	sb.fk.sg.ubest
plante	sb.fk.sg.ubest
teori	sb.fk.sg.ubest
producent	sb.fk.sg.ubest
himmel	sb.fk.sg.ubest
protest	sb.fk.sg.ubest
smil	sb.itk.sg.ubest
anmeldelse	sb.fk.sg.ubest
profil	sb.itk.sg.ubest
udstyr	sb.itk.sg.ubest
fyr	sb.fk.sg.ubest
leg	sb.fk.sg.ubest
henvendelse	sb.fk.sg.ubest
kreds	sb.fk.sg.ubest
overlæge	sb.fk.sg.ubest
ophold	sb.itk.sg.ubest
biograf	sb.fk.sg.ubest
fare	sb.fk.sg.ubest
dans	sb.fk.sg.ubest
mur	sb.fk.sg.ubest
flaske	sb.fk.sg.ubest
jøde	sb.fk.sg.ubest
prøve	sb.fk.sg.ubest
is	sb.fk.sg.ubest
rytter	sb.fk.sg.ubest
bidrag	sb.itk.sg.ubest
blomst	sb.fk.sg.ubest
balance	sb.fk.sg.ubest
betingelse	sb.fk.sg.ubest
retssag	sb.fk.sg.ubest
stribe	sb.fk.sg.ubest
begreb	sb.itk.sg.ubest
deltagelse	sb.fk.sg.ubest
vinder	sb.fk.sg.ubest
sø	sb.fk.sg.ubest
ægteskab	sb.itk.sg.ubest
kilo	sb.itk.sg.ubest
konference	sb.fk.sg.ubest
foredrag	sb.itk.sg.ubest
sæt	sb.itk.sg.ubest
vind	sb.fk.sg.ubest
forbud	sb.itk.sg.ubest
realitet	sb.fk.sg.ubest
liste	sb.fk.sg.ubest
anlæg	sb.itk.sg.ubest
erstatning	sb.fk.sg.ubest
fugl	sb.fk.sg.ubest
reklame	sb.fk.sg.ubest
prins	sb.fk.sg.ubest
division	sb.fk.sg.ubest
tiltag	sb.itk.sg.ubest
virkning	sb.fk.sg.ubest
flok	sb.fk.sg.ubest
straf	sb.fk.sg.ubest
fødselsdag	sb.fk.sg.ubest
café	sb.fk.sg.ubest
næstformand	sb.fk.sg.ubest
udgang	sb.fk.sg.ubest
sanger	sb.fk.sg.ubest
landstræner	sb.fk.sg.ubest
perspektiv	sb.itk.sg.ubest
påstand	sb.fk.sg.ubest
ydelse	sb.fk.sg.ubest
søster	sb.fk.sg.ubest
kriminalitet	sb.fk.sg.ubest
fader	sb.fk.sg.ubest
indbrud	sb.itk.sg.ubest
finansminister	sb.fk.sg.ubest
jubilæum	sb.itk.sg.ubest
tilhænger	sb.fk.sg.ubest
funktion	sb.fk.sg.ubest
afslutning	sb.fk.sg.ubest
stadion	sb.itk.sg.ubest
tjeneste	sb.fk.sg.ubest
garanti	sb.fk.sg.ubest
ordfører	sb.fk.sg.ubest
redaktør	sb.fk.sg.ubest
tredjedel	sb.fk.sg.ubest
stue	sb.fk.sg.ubest
fan	sb.fk.sg.ubest
kamera	sb.itk.sg.ubest
køber	sb.fk.sg.ubest
ansøgning	sb.fk.sg.ubest
skud	sb.itk.sg.ubest
skæbne	sb.fk.sg.ubest
bøde	sb.fk.sg.ubest
bjerg	sb.itk.sg.ubest
årrække	sb.fk.sg.ubest
overraskelse	sb.fk.sg.ubest
transport	sb.fk.sg.ubest
talsmand	sb.fk.sg.ubest
omgivelse	sb.fk.sg.ubest
mord	sb.itk.sg.ubest
ild	sb.fk.sg.ubest
virke	sb.itk.sg.ubest
motorvej	sb.fk.sg.ubest
frugt	sb.fk.sg.ubest
chauffør	sb.fk.sg.ubest
næse	sb.fk.sg.ubest
engagement	sb.itk.sg.ubest
identitet	sb.fk.sg.ubest
inspiration	sb.fk.sg.ubest
fænomen	sb.itk.sg.ubest
ordre	sb.fk.sg.ubest
ton	sb.fk.sg.ubest
loft	sb.itk.sg.ubest
kendskab	sb.itk.sg.ubest
salt	sb.itk.sg.ubest
henvisning	sb.fk.sg.ubest
hestekraft	sb.fk.sg.ubest
landskab	sb.itk.sg.ubest
standard	sb.fk.sg.ubest
blanding	sb.fk.sg.ubest
vision	sb.fk.sg.ubest
mobiltelefon	sb.fk.sg.ubest
drab	sb.itk.sg.ubest
konsulent	sb.fk.sg.ubest
sjæl	sb.fk.sg.ubest
forbrydelse	sb.fk.sg.ubest
veninde	sb.fk.sg.ubest
optagelse	sb.fk.sg.ubest
rådhus	sb.itk.sg.ubest
ungdom	sb.fk.sg.ubest
motiv	sb.itk.sg.ubest
eventyr	sb.itk.sg.ubest
traktat	sb.fk.sg.ubest
topmøde	sb.itk.sg.ubest
erhverv	sb.itk.sg.ubest
landsret	sb.fk.sg.ubest
udspil	sb.itk.sg.ubest
seer	sb.fk.sg.ubest
administration	sb.fk.sg.ubest
fange	sb.fk.sg.ubest
aktionær	sb.fk.sg.ubest
demonstration	sb.fk.sg.ubest
provins	sb.fk.sg.ubest
tilladelse	sb.fk.sg.ubest
relation	sb.fk.sg.ubest
tyv	sb.fk.sg.ubest
beskæftigelse	sb.fk.sg.ubest
afsnit	sb.itk.sg.ubest
hovedperson	sb.fk.sg.ubest
farvel	sb.itk.sg.ubest
enhed	sb.fk.sg.ubest
udlænding	sb.fk.sg.ubest
mindretal	sb.itk.sg.ubest
kritiker	sb.fk.sg.ubest
ingeniør	sb.fk.sg.ubest
liga	sb.fk.sg.ubest
arbejdsløshed	sb.fk.sg.ubest
sundhed	sb.fk.sg.ubest
undtagelse	sb.fk.sg.ubest
udvidelse	sb.fk.sg.ubest
pædagog	sb.fk.sg.ubest
afstemning	sb.fk.sg.ubest
anbefaling	sb.fk.sg.ubest
sommerferie	sb.fk.sg.ubest
orkester	sb.itk.sg.ubest
højskole	sb.fk.sg.ubest
digt	sb.itk.sg.ubest
analytiker	sb.fk.sg.ubest
minde	sb.itk.sg.ubest
forbund	sb.itk.sg.ubest
univers	sb.itk.sg.ubest
drama	sb.itk.sg.ubest
menneskerettighed	sb.fk.sg.ubest
økonom	sb.fk.sg.ubest
kompetence	sb.fk.sg.ubest
smerte	sb.fk.sg.ubest
faktor	sb.fk.sg.ubest
betragtning	sb.fk.sg.ubest
tempo	sb.itk.sg.ubest
test	sb.fk.sg.ubest
struktur	sb.fk.sg.ubest
fjende	sb.fk.sg.ubest
usikkerhed	sb.fk.sg.ubest
islam	sb.fk.sg.ubest
skulder	sb.fk.sg.ubest
overskrift	sb.fk.sg.ubest
begrundelse	sb.fk.sg.ubest
æg	sb.itk.sg.ubest
pH	sb.fk.sg.ubest
bombe	sb.fk.sg.ubest
kammerat	sb.fk.sg.ubest
meningsmåling	sb.fk.sg.ubest
præstation	sb.fk.sg.ubest
løfte	sb.itk.sg.ubest
pakke	sb.fk.sg.ubest
hals	sb.fk.sg.ubest
spænding	sb.fk.sg.ubest
trup	sb.fk.sg.ubest
enighed	sb.fk.sg.ubest
forbedring	sb.fk.sg.ubest
gavn	sb.fk.sg.ubest
sko	sb.fk.sg.ubest
bølge	sb.fk.sg.ubest
svenske	sb.fk.sg.ubest
union	sb.fk.sg.ubest
barnebarn	sb.itk.sg.ubest
overvejelse	sb.fk.sg.ubest
arrangør	sb.fk.sg.ubest
bestyrelsesformand	sb.fk.sg.ubest
ambassadør	sb.fk.sg.ubest
mandat	sb.itk.sg.ubest
katastrofe	sb.fk.sg.ubest
mave	sb.fk.sg.ubest
mission	sb.fk.sg.ubest
fotograf	sb.fk.sg.ubest
udsendelse	sb.fk.sg.ubest
sommerhus	sb.itk.sg.ubest
kræft	sb.fk.sg.ubest
fjernsyn	sb.itk.sg.ubest
efterspørgsel	sb.fk.sg.ubest
justitsminister	sb.fk.sg.ubest
middag	sb.fk.sg.ubest
rygte	sb.itk.sg.ubest
folkeafstemning	sb.fk.sg.ubest
galleri	sb.itk.sg.ubest
åbning	sb.fk.sg.ubest
and	sb.fk.sg.ubest
indtjening	sb.fk.sg.ubest
pligt	sb.fk.sg.ubest
mod	sb.itk.sg.ubest
kilogram	sb.itk.sg.ubest
mistanke	sb.fk.sg.ubest
revolution	sb.fk.sg.ubest
møbel	sb.itk.sg.ubest
anklage	sb.fk.sg.ubest
ånd	sb.fk.sg.ubest
klima	sb.itk.sg.ubest
nutid	sb.fk.sg.ubest
sammenligning	sb.fk.sg.ubest
episode	sb.fk.sg.ubest
eksport	sb.fk.sg.ubest
dato	sb.fk.sg.ubest
pensionist	sb.fk.sg.ubest
bemærkning	sb.fk.sg.ubest
betaling	sb.fk.sg.ubest
etape	sb.fk.sg.ubest
champion	sb.fk.sg.ubest
overblik	sb.itk.sg.ubest
kæde	sb.fk.sg.ubest
rekord	sb.fk.sg.ubest
barndom	sb.fk.sg.ubest
ytringsfrihed	sb.fk.sg.ubest
lag	sb.itk.sg.ubest
fagforening	sb.fk.sg.ubest
data	sb.itk.sg.ubest
venstrefløj	sb.fk.sg.ubest
supermarked	sb.itk.sg.ubest
kniv	sb.fk.sg.ubest
beskrivelse	sb.fk.sg.ubest
dokument	sb.itk.sg.ubest
kø	sb.fk.sg.ubest
genstand	sb.fk.sg.ubest
genre	sb.fk.sg.ubest
kors	sb.itk.sg.ubest
skal	sb.fk.sg.ubest
kongres	sb.fk.sg.ubest
mesterskab	sb.itk.sg.ubest
angst	sb.fk.sg.ubest
plejehjem	sb.itk.sg.ubest
overflade	sb.fk.sg.ubest
kommunikation	sb.fk.sg.ubest
lykke	sb.fk.sg.ubest
kombination	sb.fk.sg.ubest
skygge	sb.fk.sg.ubest
fantasi	sb.fk.sg.ubest
opfordring	sb.fk.sg.ubest
pointe	sb.fk.sg.ubest
beretning	sb.fk.sg.ubest
forvaltning	sb.fk.sg.ubest
tand	sb.fk.sg.ubest
video	sb.fk.sg.ubest
hensigt	sb.fk.sg.ubest
tilgang	sb.fk.sg.ubest
regime	sb.itk.sg.ubest
indsigt	sb.fk.sg.ubest
fødevare	sb.fk.sg.ubest
koncept	sb.fk.sg.ubest
advarsel	sb.fk.sg.ubest
kapitel	sb.itk.sg.ubest
grav	sb.fk.sg.ubest
adfærd	sb.fk.sg.ubest
asie	sb.fk.sg.ubest
komponist	sb.fk.sg.ubest
redaktion	sb.fk.sg.ubest
militær	sb.itk.sg.ubest
humor	sb.fk.sg.ubest
klage	sb.fk.sg.ubest
mørke	sb.itk.sg.ubest
hemmelighed	sb.fk.sg.ubest
lastbil	sb.fk.sg.ubest
målmand	sb.fk.sg.ubest
alkohol	sb.fk.sg.ubest
velfærd	sb.fk.sg.ubest
kor	sb.itk.sg.ubest
rådgiver	sb.fk.sg.ubest
forlig	sb.itk.sg.ubest
forsikring	sb.fk.sg.ubest
målsætning	sb.fk.sg.ubest
kineser	sb.fk.sg.ubest
værksted	sb.itk.sg.ubest
fritid	sb.fk.sg.ubest
udgivelse	sb.fk.sg.ubest
stik	sb.itk.sg.ubest
fusion	sb.fk.sg.ubest
udbud	sb.itk.sg.ubest
integration	sb.fk.sg.ubest
temperatur	sb.fk.sg.ubest
sektion	sb.fk.sg.ubest
bevidsthed	sb.fk.sg.ubest
favorit	sb.fk.sg.ubest
kat	sb.fk.sg.ubest
lighed	sb.fk.sg.ubest
portræt	sb.itk.sg.ubest
myte	sb.fk.sg.ubest
videnskab	sb.fk.sg.ubest
helt	sb.fk.sg.ubest
afgang	sb.fk.sg.ubest
angriber	sb.fk.sg.ubest
indeks	sb.itk.sg.ubest
terror	sb.fk.sg.ubest
sælger	sb.fk.sg.ubest
vogn	sb.fk.sg.ubest
streg	sb.fk.sg.ubest
villa	sb.fk.sg.ubest
superliga	sb.fk.sg.ubest
opgørelse	sb.fk.sg.ubest
ballade	sb.fk.sg.ubest
beregning	sb.fk.sg.ubest
nytår	sb.itk.sg.ubest
storby	sb.fk.sg.ubest
sans	sb.fk.sg.ubest
mandskab	sb.itk.sg.ubest
lukke	sb.itk.sg.ubest
generalsekretær	sb.fk.sg.ubest
magasin	sb.itk.sg.ubest
efterløn	sb.fk.sg.ubest
egn	sb.fk.sg.ubest
kategori	sb.fk.sg.ubest
kartoffel	sb.fk.sg.ubest
lig	sb.itk.sg.ubest
rektor	sb.fk.sg.ubest
bryst	sb.itk.sg.ubest
digter	sb.fk.sg.ubest
terrorist	sb.fk.sg.ubest
formue	sb.fk.sg.ubest
stop	sb.itk.sg.ubest
aktør	sb.fk.sg.ubest
ko	sb.fk.sg.ubest
indstilling	sb.fk.sg.ubest
overenskomst	sb.fk.sg.ubest
areal	sb.itk.sg.ubest
folkekirke	sb.fk.sg.ubest
reception	sb.fk.sg.ubest
kyst	sb.fk.sg.ubest
kryds	sb.itk.sg.ubest
palæstinenser	sb.fk.sg.ubest
munk	sb.fk.sg.ubest
symbol	sb.itk.sg.ubest
pressemeddelelse	sb.fk.sg.ubest
efterforskning	sb.fk.sg.ubest
udsagn	sb.itk.sg.ubest
leverandør	sb.fk.sg.ubest
fødsel	sb.fk.sg.ubest
forhandler	sb.fk.sg.ubest
mode	sb.fk.sg.ubest
skandale	sb.fk.sg.ubest
underholdning	sb.fk.sg.ubest
tråd	sb.fk.sg.ubest
agent	sb.fk.sg.ubest
flugt	sb.fk.sg.ubest
rådgivning	sb.fk.sg.ubest
uheld	sb.itk.sg.ubest
højesteret	sb.fk.sg.ubest
helhed	sb.fk.sg.ubest
kursus	sb.itk.sg.ubest
hud	sb.fk.sg.ubest
rederi	sb.itk.sg.ubest
måling	sb.fk.sg.ubest
anvendelse	sb.fk.sg.ubest
oplæg	sb.itk.sg.ubest
længde	sb.fk.sg.ubest
gas	sb.fk.sg.ubest
affære	sb.fk.sg.ubest
gen	sb.itk.sg.ubest
erindring	sb.fk.sg.ubest
opskrift	sb.fk.sg.ubest
finanslov	sb.fk.sg.ubest
kælder	sb.fk.sg.ubest
indgreb	sb.itk.sg.ubest
ambassade	sb.fk.sg.ubest
kulturminister	sb.fk.sg.ubest
regn	sb.fk.sg.ubest
oprør	sb.itk.sg.ubest
beskyttelse	sb.fk.sg.ubest
elite	sb.fk.sg.ubest
sanktion	sb.fk.sg.ubest
lidelse	sb.fk.sg.ubest
eksemplar	sb.itk.sg.ubest
folketingsmedlem	sb.itk.sg.ubest
håndværker	sb.fk.sg.ubest
semifinale	sb.fk.sg.ubest
pårørende	sb.fk.sg.ubest
pressemøde	sb.itk.sg.ubest
affald	sb.itk.sg.ubest
mælk	sb.fk.sg.ubest
nøgle	sb.fk.sg.ubest
udbytte	sb.itk.sg.ubest
flod	sb.fk.sg.ubest
brite	sb.fk.sg.ubest
brød	sb.itk.sg.ubest
redskab	sb.itk.sg.ubest
hovedrolle	sb.fk.sg.ubest
flag	sb.itk.sg.ubest
indgang	sb.fk.sg.ubest
base	sb.fk.sg.ubest
maler	sb.fk.sg.ubest
egenskab	sb.fk.sg.ubest
gennembrud	sb.itk.sg.ubest
hjemmehold	sb.itk.sg.ubest
kapital	sb.fk.sg.ubest
færge	sb.fk.sg.ubest
røveri	sb.itk.sg.ubest
færd	sb.fk.sg.ubest
forbehold	sb.itk.sg.ubest
ventetid	sb.fk.sg.ubest
uro	sb.fk.sg.ubest
kerne	sb.fk.sg.ubest
klode	sb.fk.sg.ubest
kok	sb.fk.sg.ubest
skulptur	sb.fk.sg.ubest
fornøjelse	sb.fk.sg.ubest
indkomst	sb.fk.sg.ubest
sind	sb.itk.sg.ubest
henblik	sb.itk.sg.ubest
idræt	sb.fk.sg.ubest
instrument	sb.itk.sg.ubest
ægtepar	sb.itk.sg.ubest
toilet	sb.itk.sg.ubest
ansættelse	sb.fk.sg.ubest
efterretningstjeneste	sb.fk.sg.ubest
jurist	sb.fk.sg.ubest
general	sb.fk.sg.ubest
historiker	sb.fk.sg.ubest
forside	sb.fk.sg.ubest
fornuft	sb.fk.sg.ubest
bar	sb.fk.sg.ubest
omverden	sb.fk.sg.ubest
kristendom	sb.fk.sg.ubest
bydel	sb.fk.sg.ubest
mønster	sb.itk.sg.ubest
psykolog	sb.fk.sg.ubest
pulje	sb.fk.sg.ubest
sognepræst	sb.fk.sg.ubest
sorg	sb.fk.sg.ubest
skikkelse	sb.fk.sg.ubest
chefredaktør	sb.fk.sg.ubest
anelse	sb.fk.sg.ubest
millimeter	sb.fk.sg.ubest
grin	sb.itk.sg.ubest
melodi	sb.fk.sg.ubest
biskop	sb.fk.sg.ubest
rude	sb.fk.sg.ubest
misbrug	sb.fk.sg.ubest
finansiering	sb.fk.sg.ubest
engelsk	sb.itk.sg.ubest
medalje	sb.fk.sg.ubest
prinsesse	sb.fk.sg.ubest
kørsel	sb.fk.sg.ubest
personlighed	sb.fk.sg.ubest
begejstring	sb.fk.sg.ubest
hjemmebane	sb.fk.sg.ubest
scoring	sb.fk.sg.ubest
tyveri	sb.itk.sg.ubest
meddelelse	sb.fk.sg.ubest
smør	sb.itk.sg.ubest
redegørelse	sb.fk.sg.ubest
medlemsland	sb.itk.sg.ubest
forpligtelse	sb.fk.sg.ubest
øvelse	sb.fk.sg.ubest
skjul	sb.itk.sg.ubest
knæ	sb.itk.sg.ubest
mølle	sb.fk.sg.ubest
indkøb	sb.itk.sg.ubest
lønmodtager	sb.fk.sg.ubest
pose	sb.fk.sg.ubest
omegn	sb.fk.sg.ubest
bånd	sb.itk.sg.ubest
skift	sb.itk.sg.ubest
humør	sb.itk.sg.ubest
fortsætter	sb.fk.sg.ubest
sne	sb.fk.sg.ubest
årgang	sb.fk.sg.ubest
frokost	sb.fk.sg.ubest
anerkendelse	sb.fk.sg.ubest
vinde	sb.fk.sg.ubest
bonde	sb.fk.sg.ubest
kapacitet	sb.fk.sg.ubest
erklæring	sb.fk.sg.ubest
stress	sb.fk.sg.ubest
overgang	sb.fk.sg.ubest
kop	sb.fk.sg.ubest
bind	sb.itk.sg.ubest
overgreb	sb.itk.sg.ubest
nyhedsbureau	sb.itk.sg.ubest
køn	sb.itk.sg.ubest
gårsdag	sb.fk.sg.ubest
græs	sb.itk.sg.ubest
topchef	sb.fk.sg.ubest
nedtur	sb.fk.sg.ubest
forsamlingshus	sb.itk.sg.ubest
hjemland	sb.itk.sg.ubest
undskyldning	sb.fk.sg.ubest
hovedpart	sb.fk.sg.ubest
potentiale	sb.itk.sg.ubest
manager	sb.fk.sg.ubest
arkiv	sb.itk.sg.ubest
medlemskab	sb.itk.sg.ubest
stævne	sb.itk.sg.ubest
klassiker	sb.fk.sg.ubest
stund	sb.fk.sg.ubest
student	sb.fk.sg.ubest
citat	sb.itk.sg.ubest
afkast	sb.itk.sg.ubest
torv	sb.itk.sg.ubest
etage	sb.fk.sg.ubest
kaptajn	sb.fk.sg.ubest
trappe	sb.fk.sg.ubest
verdensmester	sb.fk.sg.ubest
pande	sb.fk.sg.ubest
oprører	sb.fk.sg.ubest
bekendt	sb.fk.sg.ubest
arkitektur	sb.fk.sg.ubest
løgn	sb.fk.sg.ubest
ledighed	sb.fk.sg.ubest
konto	sb.fk.sg.ubest
vejledning	sb.fk.sg.ubest
lom	sb.fk.sg.ubest
kvalifikation	sb.fk.sg.ubest
eksamen	sb.fk.sg.ubest
skattelettelse	sb.fk.sg.ubest
lukning	sb.fk.sg.ubest
manuskript	sb.itk.sg.ubest
håndfuld	sb.fk.sg.ubest
tidsskrift	sb.itk.sg.ubest
tilknytning	sb.fk.sg.ubest
indslag	sb.itk.sg.ubest
sandsynlighed	sb.fk.sg.ubest
blok	sb.fk.sg.ubest
snes	sb.fk.sg.ubest
begrænsning	sb.fk.sg.ubest
sætning	sb.fk.sg.ubest
læsning	sb.fk.sg.ubest
valuta	sb.fk.sg.ubest
anmelder	sb.fk.sg.ubest
tryghed	sb.fk.sg.ubest
grundlov	sb.fk.sg.ubest
revisor	sb.fk.sg.ubest
motion	sb.fk.sg.ubest
kendsgerning	sb.fk.sg.ubest
arena	sb.fk.sg.ubest
fattigdom	sb.fk.sg.ubest
demonstrant	sb.fk.sg.ubest
allé	sb.fk.sg.ubest
betegnelse	sb.fk.sg.ubest
plakat	sb.fk.sg.ubest
fund	sb.itk.sg.ubest
pind	sb.fk.sg.ubest
uenighed	sb.fk.sg.ubest
celle	sb.fk.sg.ubest
vest	sb.fk.sg.ubest
præg	sb.itk.sg.ubest
rus	sb.fk.sg.ubest
kompromis	sb.itk.sg.ubest
forsvarsminister	sb.fk.sg.ubest
sofa	sb.fk.sg.ubest
hat	sb.fk.sg.ubest
fotografi	sb.itk.sg.ubest
demokrat	sb.fk.sg.ubest
dokumentation	sb.fk.sg.ubest
bænk	sb.fk.sg.ubest
halvår	sb.itk.sg.ubest
nød	sb.fk.sg.ubest
væsen	sb.itk.sg.ubest
pas	sb.fk.sg.ubest
ære	sb.fk.sg.ubest
erkendelse	sb.fk.sg.ubest
borgerkrig	sb.fk.sg.ubest
sponsor	sb.fk.sg.ubest
etablering	sb.fk.sg.ubest
arv	sb.fk.sg.ubest
team	sb.itk.sg.ubest
sår	sb.itk.sg.ubest
peber	sb.itk.sg.ubest
værktøj	sb.itk.sg.ubest
bakke	sb.fk.sg.ubest
forberedelse	sb.fk.sg.ubest
oversættelse	sb.fk.sg.ubest
plus	sb.itk.sg.ubest
atmosfære	sb.fk.sg.ubest
markedsføring	sb.fk.sg.ubest
arbejdstid	sb.fk.sg.ubest
nul	sb.itk.sg.ubest
besættelse	sb.fk.sg.ubest
bande	sb.fk.sg.ubest
fremskridt	sb.itk.sg.ubest
latter	sb.fk.sg.ubest
kaos	sb.itk.sg.ubest
leje	sb.itk.sg.ubest
øg	sb.itk.sg.ubest
benzin	sb.fk.sg.ubest
planlægning	sb.fk.sg.ubest
rock	sb.fk.sg.ubest
centralbank	sb.fk.sg.ubest
buks	sb.fk.sg.ubest
dimension	sb.fk.sg.ubest
dæk	sb.itk.sg.ubest
individ	sb.itk.sg.ubest
korruption	sb.fk.sg.ubest
disciplin	sb.fk.sg.ubest
vrede	sb.fk.sg.ubest
ægtefælle	sb.fk.sg.ubest
arbejder	sb.fk.sg.ubest
ros	sb.itk.sg.ubest
forlængelse	sb.fk.sg.ubest
byret	sb.fk.sg.ubest
dirigent	sb.fk.sg.ubest
tryk	sb.itk.sg.ubest
debut	sb.fk.sg.ubest
taske	sb.fk.sg.ubest
kommentator	sb.fk.sg.ubest
obligation	sb.fk.sg.ubest
udseende	sb.itk.sg.ubest
forfatning	sb.fk.sg.ubest
hastighed	sb.fk.sg.ubest
gudstjeneste	sb.fk.sg.ubest
fortolkning	sb.fk.sg.ubest
sigte	sb.itk.sg.ubest
bekæmpelse	sb.fk.sg.ubest
bakterie	sb.fk.sg.ubest
moral	sb.fk.sg.ubest
fagbevægelse	sb.fk.sg.ubest
slutrunde	sb.fk.sg.ubest
syge	sb.fk.sg.ubest
ansøger	sb.fk.sg.ubest
stabilitet	sb.fk.sg.ubest
rige	sb.itk.sg.ubest
vindmølle	sb.fk.sg.ubest
filosofi	sb.fk.sg.ubest
selvmord	sb.itk.sg.ubest
storm	sb.fk.sg.ubest
delstat	sb.fk.sg.ubest
spring	sb.itk.sg.ubest
samvittighed	sb.fk.sg.ubest
sky	sb.fk.sg.ubest
teenager	sb.fk.sg.ubest
annonce	sb.fk.sg.ubest
bestræbelse	sb.fk.sg.ubest
skuffelse	sb.fk.sg.ubest
guitar	sb.fk.sg.ubest
forgænger	sb.fk.sg.ubest
minimum	sb.itk.sg.ubest
optimisme	sb.fk.sg.ubest
kjole	sb.fk.sg.ubest
køretøj	sb.itk.sg.ubest
nedskæring	sb.fk.sg.ubest
fyring	sb.fk.sg.ubest
omtale	sb.fk.sg.ubest
udmelding	sb.fk.sg.ubest
bestemmelse	sb.fk.sg.ubest
skatteminister	sb.fk.sg.ubest
kost	sb.fk.sg.ubest
ur	sb.itk.sg.ubest
hylde	sb.fk.sg.ubest
landevej	sb.fk.sg.ubest
københavner	sb.fk.sg.ubest
eksistens	sb.fk.sg.ubest
boligejer	sb.fk.sg.ubest
europæer	sb.fk.sg.ubest
officer	sb.fk.sg.ubest
cigaret	sb.fk.sg.ubest
inflation	sb.fk.sg.ubest
guide	sb.fk.sg.ubest
styrelse	sb.fk.sg.ubest
gods	sb.itk.sg.ubest
direktion	sb.fk.sg.ubest
renovering	sb.fk.sg.ubest
søvn	sb.fk.sg.ubest
fundament	sb.itk.sg.ubest
overensstemmelse	sb.fk.sg.ubest
republik	sb.fk.sg.ubest
styre	sb.itk.sg.ubest
bor	sb.itk.sg.ubest
bureau	sb.itk.sg.ubest
høring	sb.fk.sg.ubest
kronik	sb.fk.sg.ubest
metal	sb.itk.sg.ubest
skive	sb.fk.sg.ubest
fase	sb.fk.sg.ubest
forsikringsselskab	sb.itk.sg.ubest
udledning	sb.fk.sg.ubest
forsvarer	sb.fk.sg.ubest
gryde	sb.fk.sg.ubest
spørgsmålstegn	sb.itk.sg.ubest
hjul	sb.itk.sg.ubest
præmie	sb.fk.sg.ubest
deciliter	sb.fk.sg.ubest
messe	sb.fk.sg.ubest
englænder	sb.fk.sg.ubest
kølvand	sb.itk.sg.ubest
måltid	sb.itk.sg.ubest
problemstilling	sb.fk.sg.ubest
købmand	sb.fk.sg.ubest
speciale	sb.itk.sg.ubest
ligestilling	sb.fk.sg.ubest
fodboldspiller	sb.fk.sg.ubest
skilsmisse	sb.fk.sg.ubest
eksperiment	sb.itk.sg.ubest
kunstmuseum	sb.itk.sg.ubest
business	sb.fk.sg.ubest
nakke	sb.fk.sg.ubest
tilsyn	sb.itk.sg.ubest
omsorg	sb.fk.sg.ubest
serber	sb.fk.sg.ubest
frustration	sb.fk.sg.ubest
konstruktion	sb.fk.sg.ubest
menu	sb.fk.sg.ubest
dødsfald	sb.itk.sg.ubest
mellemrum	sb.itk.sg.ubest
telt	sb.itk.sg.ubest
udfald	sb.itk.sg.ubest
duft	sb.fk.sg.ubest
bryllup	sb.itk.sg.ubest
overfald	sb.itk.sg.ubest
menighedsråd	sb.itk.sg.ubest
svensker	sb.fk.sg.ubest
brille	sb.fk.sg.ubest
aspekt	sb.itk.sg.ubest
bagside	sb.fk.sg.ubest
fremstilling	sb.fk.sg.ubest
pol	sb.fk.sg.ubest
skønhed	sb.fk.sg.ubest
kronprins	sb.fk.sg.ubest
pave	sb.fk.sg.ubest
rabat	sb.fk.sg.ubest
sparekasse	sb.fk.sg.ubest
sti	sb.fk.sg.ubest
norm	sb.fk.sg.ubest
sinde	sb.fk.sg.ubest
format	sb.itk.sg.ubest
designer	sb.fk.sg.ubest
engel	sb.fk.sg.ubest
moms	sb.fk.sg.ubest
paragraf	sb.fk.sg.ubest
bryggeri	sb.itk.sg.ubest
opførelse	sb.fk.sg.ubest
anklagemyndighed	sb.fk.sg.ubest
sekretær	sb.fk.sg.ubest
rune	sb.fk.sg.ubest
anklager	sb.fk.sg.ubest
æble	sb.itk.sg.ubest
kommunalbestyrelse	sb.fk.sg.ubest
værft	sb.itk.sg.ubest
fordeling	sb.fk.sg.ubest
læserbrev	sb.itk.sg.ubest
forurening	sb.fk.sg.ubest
årsskifte	sb.itk.sg.ubest
jazz	sb.fk.sg.ubest
sammenstød	sb.itk.sg.ubest
skoleleder	sb.fk.sg.ubest
cyklist	sb.fk.sg.ubest
skuespil	sb.itk.sg.ubest
stift	sb.fk.sg.ubest
konvention	sb.fk.sg.ubest
statsborger	sb.fk.sg.ubest
besiddelse	sb.fk.sg.ubest
pilot	sb.fk.sg.ubest
vanskelighed	sb.fk.sg.ubest
entré	sb.fk.sg.ubest
kopi	sb.fk.sg.ubest
selvtillid	sb.fk.sg.ubest
helvede	sb.itk.sg.ubest
dækning	sb.fk.sg.ubest
styring	sb.fk.sg.ubest
el	sb.fk.sg.ubest
komedie	sb.fk.sg.ubest
andenplads	sb.fk.sg.ubest
præsidentvalg	sb.itk.sg.ubest
tørklæde	sb.itk.sg.ubest
opvarmning	sb.fk.sg.ubest
symptom	sb.itk.sg.ubest
dagligdag	sb.fk.sg.ubest
helbred	sb.itk.sg.ubest
sundhedsvæsen	sb.itk.sg.ubest
skab	sb.itk.sg.ubest
infrastruktur	sb.fk.sg.ubest
italiener	sb.fk.sg.ubest
pianist	sb.fk.sg.ubest
auktion	sb.fk.sg.ubest
asylansøger	sb.fk.sg.ubest
kontorchef	sb.fk.sg.ubest
sangerinde	sb.fk.sg.ubest
port	sb.fk.sg.ubest
strækning	sb.fk.sg.ubest
pund	sb.itk.sg.ubest
slagsmål	sb.itk.sg.ubest
plet	sb.itk.sg.ubest
hovedkvarter	sb.itk.sg.ubest
løber	sb.fk.sg.ubest
sukker	sb.itk.sg.ubest
tilstedeværelse	sb.fk.sg.ubest
danser	sb.fk.sg.ubest
gerningsmand	sb.fk.sg.ubest
rør	sb.itk.sg.ubest
opkøb	sb.itk.sg.ubest
klinik	sb.fk.sg.ubest
lager	sb.fk.sg.ubest
lyde	sb.fk.sg.ubest
miljøminister	sb.fk.sg.ubest
nazist	sb.fk.sg.ubest
kage	sb.fk.sg.ubest
indretning	sb.fk.sg.ubest
daginstitution	sb.fk.sg.ubest
forbillede	sb.itk.sg.ubest
platform	sb.fk.sg.ubest
basis	sb.fk.sg.ubest
overvågning	sb.fk.sg.ubest
tæppe	sb.itk.sg.ubest
bio	sb.fk.sg.ubest
hærværk	sb.itk.sg.ubest
morgenavis	sb.fk.sg.ubest
venskab	sb.itk.sg.ubest
fynbo	sb.fk.sg.ubest
depression	sb.fk.sg.ubest
afslag	sb.itk.sg.ubest
sogn	sb.itk.sg.ubest
tragedie	sb.fk.sg.ubest
strejke	sb.fk.sg.ubest
fravær	sb.itk.sg.ubest
fløj	sb.fk.sg.ubest
notat	sb.itk.sg.ubest
republikaner	sb.fk.sg.ubest
parkeringsplads	sb.fk.sg.ubest
vagt	sb.fk.sg.ubest
instruktion	sb.fk.sg.ubest
højdepunkt	sb.itk.sg.ubest
datterselskab	sb.itk.sg.ubest
musical	sb.fk.sg.ubest
spiseskefuld	sb.fk.sg.ubest
regi	sb.fk.sg.ubest
image	sb.itk.sg.ubest
fordom	sb.fk.sg.ubest
gris	sb.fk.sg.ubest
matematik	sb.fk.sg.ubest
portion	sb.fk.sg.ubest
godkendelse	sb.fk.sg.ubest
satsning	sb.fk.sg.ubest
bistand	sb.fk.sg.ubest
bevilling	sb.fk.sg.ubest
trin	sb.itk.sg.ubest
diagnose	sb.fk.sg.ubest
organ	sb.itk.sg.ubest
lampe	sb.fk.sg.ubest
lønning	sb.fk.sg.ubest
skilt	sb.itk.sg.ubest
tankegang	sb.fk.sg.ubest
sølv	sb.itk.sg.ubest
klient	sb.fk.sg.ubest
trøje	sb.fk.sg.ubest
vinkel	sb.fk.sg.ubest
minus	sb.itk.sg.ubest
prognose	sb.fk.sg.ubest
dybde	sb.fk.sg.ubest
modtager	sb.fk.sg.ubest
røver	sb.fk.sg.ubest
diplomat	sb.fk.sg.ubest
lokalplan	sb.fk.sg.ubest
race	sb.itk.sg.ubest
bøn	sb.fk.sg.ubest
nødvendighed	sb.fk.sg.ubest
voks	sb.fk.sg.ubest
stamme	sb.fk.sg.ubest
trio	sb.fk.sg.ubest
filosof	sb.fk.sg.ubest
løft	sb.itk.sg.ubest
tortur	sb.fk.sg.ubest
hændelse	sb.fk.sg.ubest
fisker	sb.fk.sg.ubest
afsløring	sb.fk.sg.ubest
udvisning	sb.fk.sg.ubest
rose	sb.fk.sg.ubest
hjort	sb.fk.sg.ubest
check	sb.fk.sg.ubest
arbejdsmiljø	sb.itk.sg.ubest
tilmelding	sb.fk.sg.ubest
rådmand	sb.fk.sg.ubest
bid	sb.itk.sg.ubest
reduktion	sb.fk.sg.ubest
chok	sb.itk.sg.ubest
ovn	sb.fk.sg.ubest
førsteplads	sb.fk.sg.ubest
gebyr	sb.itk.sg.ubest
efterskole	sb.fk.sg.ubest
veteran	sb.fk.sg.ubest
skatteyder	sb.fk.sg.ubest
pistol	sb.fk.sg.ubest
intention	sb.fk.sg.ubest
ost	sb.fk.sg.ubest
hash	sb.fk.sg.ubest
bogstav	sb.itk.sg.ubest
spekulation	sb.fk.sg.ubest
logik	sb.fk.sg.ubest
chokolade	sb.fk.sg.ubest
revy	sb.fk.sg.ubest
grafik	sb.fk.sg.ubest
triumf	sb.fk.sg.ubest
folketingsvalg	sb.itk.sg.ubest
kommunist	sb.fk.sg.ubest
landskamp	sb.fk.sg.ubest
fortæller	sb.fk.sg.ubest
distance	sb.fk.sg.ubest
bad	sb.itk.sg.ubest
ulighed	sb.fk.sg.ubest
kontanthjælp	sb.fk.sg.ubest
taber	sb.fk.sg.ubest
forsinkelse	sb.fk.sg.ubest
fysik	sb.fk.sg.ubest
kørekort	sb.itk.sg.ubest
sundhedsminister	sb.fk.sg.ubest
mellemtid	sb.fk.sg.ubest
ideologi	sb.fk.sg.ubest
skål	sb.fk.sg.ubest
gennemgang	sb.fk.sg.ubest
opløsning	sb.fk.sg.ubest
udslip	sb.itk.sg.ubest
lav	sb.itk.sg.ubest
svaghed	sb.fk.sg.ubest
løg	sb.itk.sg.ubest
landsholdsspiller	sb.fk.sg.ubest
ankomst	sb.fk.sg.ubest
undervisningsminister	sb.fk.sg.ubest
apparat	sb.itk.sg.ubest
smykke	sb.itk.sg.ubest
beskyldning	sb.fk.sg.ubest
kontrast	sb.fk.sg.ubest
pille	sb.fk.sg.ubest
single	sb.fk.sg.ubest
iværksætter	sb.fk.sg.ubest
tennis	sb.fk.sg.ubest
dannelse	sb.fk.sg.ubest
helikopter	sb.fk.sg.ubest
skrift	sb.itk.sg.ubest
husleje	sb.fk.sg.ubest
holdkammerat	sb.fk.sg.ubest
klaver	sb.itk.sg.ubest
præmis	sb.fk.sg.ubest
opbygning	sb.fk.sg.ubest
flyselskab	sb.itk.sg.ubest
privatliv	sb.itk.sg.ubest
overtrædelse	sb.fk.sg.ubest
autoritet	sb.fk.sg.ubest
egenkapital	sb.fk.sg.ubest
dilemma	sb.itk.sg.ubest
frist	sb.fk.sg.ubest
aktivist	sb.fk.sg.ubest
stige	sb.fk.sg.ubest
råvare	sb.fk.sg.ubest
voldtægt	sb.fk.sg.ubest
skepsis	sb.fk.sg.ubest
kylling	sb.fk.sg.ubest
livsstil	sb.fk.sg.ubest
kontinent	sb.itk.sg.ubest
bred	sb.fk.sg.ubest
besætning	sb.fk.sg.ubest
globalisering	sb.fk.sg.ubest
had	sb.itk.sg.ubest
ry	sb.itk.sg.ubest
facade	sb.fk.sg.ubest
føring	sb.fk.sg.ubest
bod	sb.fk.sg.ubest
gren	sb.fk.sg.ubest
indenrigsminister	sb.fk.sg.ubest
te	sb.fk.sg.ubest
kalender	sb.fk.sg.ubest
vinge	sb.fk.sg.ubest
vending	sb.fk.sg.ubest
eksplosion	sb.fk.sg.ubest
samarbejdspartner	sb.fk.sg.ubest
kommissær	sb.fk.sg.ubest
kirkegård	sb.fk.sg.ubest
sympati	sb.fk.sg.ubest
solist	sb.fk.sg.ubest
forfatterskab	sb.itk.sg.ubest
snit	sb.itk.sg.ubest
back	sb.fk.sg.ubest
indblik	sb.itk.sg.ubest
alarm	sb.fk.sg.ubest
procedure	sb.fk.sg.ubest
kulisse	sb.fk.sg.ubest
symfoniorkester	sb.itk.sg.ubest
iraker	sb.fk.sg.ubest
motorcykel	sb.fk.sg.ubest
velfærdssamfund	sb.itk.sg.ubest
tunge	sb.fk.sg.ubest
svømmehal	sb.fk.sg.ubest
naboland	sb.itk.sg.ubest
røg	sb.fk.sg.ubest
due	sb.fk.sg.ubest
salat	sb.fk.sg.ubest
koncentration	sb.fk.sg.ubest
nævn	sb.itk.sg.ubest
journalistik	sb.fk.sg.ubest
pengeinstitut	sb.itk.sg.ubest
støj	sb.fk.sg.ubest
sats	sb.fk.sg.ubest
sæd	sb.fk.sg.ubest
forstad	sb.fk.sg.ubest
fad	sb.itk.sg.ubest
samvær	sb.itk.sg.ubest
landmand	sb.fk.sg.ubest
værd	sb.itk.sg.ubest
ideal	sb.itk.sg.ubest
topscorer	sb.fk.sg.ubest
biografi	sb.fk.sg.ubest
spejl	sb.itk.sg.ubest
tårn	sb.itk.sg.ubest
gruppeformand	sb.fk.sg.ubest
børnefamilie	sb.fk.sg.ubest
mønt	sb.fk.sg.ubest
assistent	sb.fk.sg.ubest
fondsbørs	sb.fk.sg.ubest
sving	sb.itk.sg.ubest
indvandring	sb.fk.sg.ubest
forsamling	sb.fk.sg.ubest
dagbog	sb.fk.sg.ubest
kulde	sb.fk.sg.ubest
sammenbrud	sb.itk.sg.ubest
ambulance	sb.fk.sg.ubest
kører	sb.fk.sg.ubest
stramning	sb.fk.sg.ubest
jakke	sb.fk.sg.ubest
rat	sb.itk.sg.ubest
anholdelse	sb.fk.sg.ubest
turisme	sb.fk.sg.ubest
definition	sb.fk.sg.ubest
israeler	sb.fk.sg.ubest
påske	sb.fk.sg.ubest
zone	sb.fk.sg.ubest
sum	sb.fk.sg.ubest
mus	sb.fk.sg.ubest
svin	sb.itk.sg.ubest
glimt	sb.itk.sg.ubest
samspil	sb.itk.sg.ubest
tilslutning	sb.fk.sg.ubest
terrorangreb	sb.itk.sg.ubest
morder	sb.fk.sg.ubest
passage	sb.fk.sg.ubest
køleskab	sb.itk.sg.ubest
fakultet	sb.itk.sg.ubest
fjerdedel	sb.fk.sg.ubest
tænketank	sb.fk.sg.ubest
katalog	sb.fk.sg.ubest
pleje	sb.fk.sg.ubest
præsentation	sb.fk.sg.ubest
kvartfinale	sb.fk.sg.ubest
vise	sb.fk.sg.ubest
overbevisning	sb.fk.sg.ubest
kunstværk	sb.itk.sg.ubest
arbejdsliv	sb.itk.sg.ubest
busk	sb.fk.sg.ubest
tusind	sb.itk.sg.ubest
rytme	sb.fk.sg.ubest
tjener	sb.fk.sg.ubest
formel	sb.fk.sg.ubest
bagage	sb.fk.sg.ubest
kongehus	sb.itk.sg.ubest
kvote	sb.fk.sg.ubest
misforståelse	sb.fk.sg.ubest
tålmodighed	sb.fk.sg.ubest
innovation	sb.fk.sg.ubest
skala	sb.fk.sg.ubest
sult	sb.fk.sg.ubest
venteliste	sb.fk.sg.ubest
udbrud	sb.itk.sg.ubest
afsked	sb.fk.sg.ubest
fornyelse	sb.fk.sg.ubest
muskel	sb.fk.sg.ubest
gear	sb.itk.sg.ubest
lange	sb.fk.sg.ubest
spise	sb.fk.sg.ubest
kommunalvalg	sb.itk.sg.ubest
bopæl	sb.fk.sg.ubest
fører	sb.fk.sg.ubest
ær	sb.fk.sg.ubest
apotek	sb.itk.sg.ubest
tåre	sb.fk.sg.ubest
trend	sb.fk.sg.ubest
bunke	sb.fk.sg.ubest
opdagelse	sb.fk.sg.ubest
cheftræner	sb.fk.sg.ubest
kig	sb.itk.sg.ubest
taxa	sb.fk.sg.ubest
onkel	sb.fk.sg.ubest
karantæne	sb.fk.sg.ubest
boligmarked	sb.itk.sg.ubest
retningslinje	sb.fk.sg.ubest
indførelse	sb.fk.sg.ubest
civilingeniør	sb.fk.sg.ubest
skattereform	sb.fk.sg.ubest
fiasko	sb.fk.sg.ubest
asyl	sb.itk.sg.ubest
panik	sb.fk.sg.ubest
cirkus	sb.itk.sg.ubest
bagland	sb.itk.sg.ubest
oprettelse	sb.fk.sg.ubest
prioritering	sb.fk.sg.ubest
ejendomsmægler	sb.fk.sg.ubest
bekostning	sb.fk.sg.ubest
iagttager	sb.fk.sg.ubest
suppe	sb.fk.sg.ubest
slagteri	sb.itk.sg.ubest
kejser	sb.fk.sg.ubest
aktiv	sb.itk.sg.ubest
partifælle	sb.fk.sg.ubest
legetøj	sb.itk.sg.ubest
handelshøjskole	sb.fk.sg.ubest
regulering	sb.fk.sg.ubest
afsæt	sb.itk.sg.ubest
ballet	sb.fk.sg.ubest
håndtering	sb.fk.sg.ubest
stilhed	sb.fk.sg.ubest
abort	sb.fk.sg.ubest
samråd	sb.itk.sg.ubest
afhøring	sb.fk.sg.ubest
comeback	sb.itk.sg.ubest
specialist	sb.fk.sg.ubest
statskasse	sb.fk.sg.ubest
kære	sb.fk.sg.ubest
paradis	sb.itk.sg.ubest
indehaver	sb.fk.sg.ubest
novelle	sb.fk.sg.ubest
tønde	sb.fk.sg.ubest
anliggende	sb.itk.sg.ubest
akademi	sb.itk.sg.ubest
stald	sb.fk.sg.ubest
batteri	sb.itk.sg.ubest
akademiker	sb.fk.sg.ubest
trang	sb.fk.sg.ubest
revision	sb.fk.sg.ubest
variation	sb.fk.sg.ubest
håndværk	sb.itk.sg.ubest
opsætning	sb.fk.sg.ubest
golf	sb.fk.sg.ubest
hit	sb.itk.sg.ubest
rocker	sb.fk.sg.ubest
kugle	sb.fk.sg.ubest
jæger	sb.fk.sg.ubest
formulering	sb.fk.sg.ubest
borg	sb.fk.sg.ubest
brændstof	sb.itk.sg.ubest
flamme	sb.fk.sg.ubest
udbygning	sb.fk.sg.ubest
terrorisme	sb.fk.sg.ubest
morgenmad	sb.fk.sg.ubest
tavshed	sb.fk.sg.ubest
offensiv	sb.fk.sg.ubest
spanier	sb.fk.sg.ubest
begravelse	sb.fk.sg.ubest
pop	sb.fk.sg.ubest
retfærdighed	sb.fk.sg.ubest
husstand	sb.fk.sg.ubest
åbningstid	sb.fk.sg.ubest
lytter	sb.fk.sg.ubest
lettelse	sb.fk.sg.ubest
ravn	sb.fk.sg.ubest
middelalder	sb.fk.sg.ubest
gidsel	sb.itk.sg.ubest
brik	sb.fk.sg.ubest
ulempe	sb.fk.sg.ubest
retorik	sb.fk.sg.ubest
entreprenør	sb.fk.sg.ubest
krimi	sb.fk.sg.ubest
doping	sb.fk.sg.ubest
duo	sb.fk.sg.ubest
raket	sb.fk.sg.ubest
tallerken	sb.fk.sg.ubest
rengøring	sb.fk.sg.ubest
varsel	sb.itk.sg.ubest
badeværelse	sb.itk.sg.ubest
opførsel	sb.fk.sg.ubest
fortjeneste	sb.fk.sg.ubest
fanden	sb.fk.sg.ubest
juletræ	sb.itk.sg.ubest
får	sb.itk.sg.ubest
låg	sb.itk.sg.ubest
overlevelse	sb.fk.sg.ubest
udbetaling	sb.fk.sg.ubest
udlån	sb.itk.sg.ubest
licens	sb.fk.sg.ubest
løve	sb.fk.sg.ubest
nedgang	sb.fk.sg.ubest
udenrigspolitik	sb.fk.sg.ubest
match	sb.itk.sg.ubest
billedkunstner	sb.fk.sg.ubest
kreativitet	sb.fk.sg.ubest
hegn	sb.itk.sg.ubest
solidaritet	sb.fk.sg.ubest
bedrift	sb.fk.sg.ubest
lærred	sb.itk.sg.ubest
bonus	sb.fk.sg.ubest
jordskælv	sb.itk.sg.ubest
direktiv	sb.itk.sg.ubest
spar	sb.fk.sg.ubest
diktator	sb.fk.sg.ubest
repertoire	sb.itk.sg.ubest
sand	sb.itk.sg.ubest
vers	sb.itk.sg.ubest
reserve	sb.fk.sg.ubest
overborgmester	sb.fk.sg.ubest
klip	sb.itk.sg.ubest
urolighed	sb.fk.sg.ubest
hukommelse	sb.fk.sg.ubest
ombudsmand	sb.fk.sg.ubest
overtagelse	sb.fk.sg.ubest
robot	sb.fk.sg.ubest
afhandling	sb.fk.sg.ubest
udstrækning	sb.fk.sg.ubest
filminstruktør	sb.fk.sg.ubest
højrefløj	sb.fk.sg.ubest
guitarist	sb.fk.sg.ubest
underskrift	sb.fk.sg.ubest
mareridt	sb.itk.sg.ubest
offentliggørelse	sb.fk.sg.ubest
konfrontation	sb.fk.sg.ubest
senior	sb.fk.sg.ubest
vedligeholdelse	sb.fk.sg.ubest
velstand	sb.fk.sg.ubest
skadestue	sb.fk.sg.ubest
motivation	sb.fk.sg.ubest
opvækst	sb.fk.sg.ubest
bak	sb.fk.sg.ubest
spilletid	sb.fk.sg.ubest
sammenslutning	sb.fk.sg.ubest
ekspedition	sb.fk.sg.ubest
ryger	sb.fk.sg.ubest
bekendtskab	sb.itk.sg.ubest
tiger	sb.fk.sg.ubest
friskole	sb.fk.sg.ubest
sigtelse	sb.fk.sg.ubest
rødvin	sb.fk.sg.ubest
ombygning	sb.fk.sg.ubest
oprindelse	sb.fk.sg.ubest
menneskehed	sb.fk.sg.ubest
planet	sb.fk.sg.ubest
variant	sb.fk.sg.ubest
skribent	sb.fk.sg.ubest
efteruddannelse	sb.fk.sg.ubest
konkurrenceevne	sb.fk.sg.ubest
tunnel	sb.fk.sg.ubest
poesi	sb.fk.sg.ubest
russer	sb.fk.sg.ubest
flytning	sb.fk.sg.ubest
tandlæge	sb.fk.sg.ubest
invitation	sb.fk.sg.ubest
ruin	sb.fk.sg.ubest
forstander	sb.fk.sg.ubest
stopper	sb.fk.sg.ubest
opholdstilladelse	sb.fk.sg.ubest
afløser	sb.fk.sg.ubest
projektleder	sb.fk.sg.ubest
tredjeplads	sb.fk.sg.ubest
udskiftning	sb.fk.sg.ubest
jernbane	sb.fk.sg.ubest
skjorte	sb.fk.sg.ubest
islamist	sb.fk.sg.ubest
tå	sb.fk.sg.ubest
menighed	sb.fk.sg.ubest
arbejdsdag	sb.fk.sg.ubest
badminton	sb.fk.sg.ubest
tomat	sb.fk.sg.ubest
pølse	sb.fk.sg.ubest
speciallæge	sb.fk.sg.ubest
bål	sb.itk.sg.ubest
rival	sb.fk.sg.ubest
facilitet	sb.fk.sg.ubest
dyd	sb.fk.sg.ubest
opstilling	sb.fk.sg.ubest
fiskeri	sb.itk.sg.ubest
red	sb.fk.sg.ubest
nuance	sb.fk.sg.ubest
opsparing	sb.fk.sg.ubest
målgruppe	sb.fk.sg.ubest
påvirkning	sb.fk.sg.ubest
iscenesættelse	sb.fk.sg.ubest
import	sb.fk.sg.ubest
nerve	sb.fk.sg.ubest
imam	sb.fk.sg.ubest
terræn	sb.itk.sg.ubest
baby	sb.fk.sg.ubest
last	sb.fk.sg.ubest
skrivebord	sb.itk.sg.ubest
nødhjælp	sb.fk.sg.ubest
hollænder	sb.fk.sg.ubest
rækkevidde	sb.fk.sg.ubest
regnskabsår	sb.itk.sg.ubest
indsamling	sb.fk.sg.ubest
container	sb.fk.sg.ubest
belastning	sb.fk.sg.ubest
turné	sb.fk.sg.ubest
lokalområde	sb.itk.sg.ubest
cykling	sb.fk.sg.ubest
ris	sb.itk.sg.ubest
boks	sb.fk.sg.ubest
møgso	sb.fk.sg.ubest
koncertsal	sb.fk.sg.ubest
installation	sb.fk.sg.ubest
tilfældighed	sb.fk.sg.ubest
drøftelse	sb.fk.sg.ubest
overnatning	sb.fk.sg.ubest
ingrediens	sb.fk.sg.ubest
champagne	sb.fk.sg.ubest
flåde	sb.fk.sg.ubest
facon	sb.fk.sg.ubest
bugt	sb.fk.sg.ubest
rutine	sb.fk.sg.ubest
hilsen	sb.fk.sg.ubest
distrikt	sb.itk.sg.ubest
management	sb.itk.sg.ubest
skildring	sb.fk.sg.ubest
diskotek	sb.itk.sg.ubest
efterfølger	sb.fk.sg.ubest
lillebror	sb.fk.sg.ubest
læbe	sb.fk.sg.ubest
sejlads	sb.fk.sg.ubest
tegner	sb.fk.sg.ubest
accept	sb.fk.sg.ubest
mirakel	sb.itk.sg.ubest
appel	sb.fk.sg.ubest
profet	sb.fk.sg.ubest
abe	sb.fk.sg.ubest
fedt	sb.itk.sg.ubest
selvstyre	sb.itk.sg.ubest
gerning	sb.fk.sg.ubest
legende	sb.fk.sg.ubest
evaluering	sb.fk.sg.ubest
komme	sb.itk.sg.ubest
kulturhus	sb.itk.sg.ubest
metro	sb.fk.sg.ubest
effektivitet	sb.fk.sg.ubest
brag	sb.itk.sg.ubest
ministerpræsident	sb.fk.sg.ubest
bibel	sb.fk.sg.ubest
klimaforandring	sb.fk.sg.ubest
fiktion	sb.fk.sg.ubest
racisme	sb.fk.sg.ubest
svamp	sb.fk.sg.ubest
komiker	sb.fk.sg.ubest
etik	sb.fk.sg.ubest
popularitet	sb.fk.sg.ubest
grundlovsforhør	sb.itk.sg.ubest
udbredelse	sb.fk.sg.ubest
statsborgerskab	sb.itk.sg.ubest
cheføkonom	sb.fk.sg.ubest
cirkel	sb.fk.sg.ubest
komité	sb.fk.sg.ubest
underviser	sb.fk.sg.ubest
terrasse	sb.fk.sg.ubest
scenografi	sb.fk.sg.ubest
formandskab	sb.itk.sg.ubest
hæl	sb.fk.sg.ubest
rygning	sb.fk.sg.ubest
politibetjent	sb.fk.sg.ubest
forum	sb.itk.sg.ubest
horisont	sb.fk.sg.ubest
tilbagegang	sb.fk.sg.ubest
bundlinje	sb.fk.sg.ubest
legeplads	sb.fk.sg.ubest
bronze	sb.fk.sg.ubest
forebyggelse	sb.fk.sg.ubest
kompensation	sb.fk.sg.ubest
testamente	sb.itk.sg.ubest
koalition	sb.fk.sg.ubest
kansler	sb.fk.sg.ubest
omlægning	sb.fk.sg.ubest
greb	sb.fk.sg.ubest
skam	sb.fk.sg.ubest
udnyttelse	sb.fk.sg.ubest
værtshus	sb.itk.sg.ubest
symfoni	sb.fk.sg.ubest
mobil	sb.fk.sg.ubest
invasion	sb.fk.sg.ubest
skøn	sb.itk.sg.ubest
beredskab	sb.itk.sg.ubest
lægemiddel	sb.itk.sg.ubest
sild	sb.fk.sg.ubest
pirat	sb.fk.sg.ubest
ekspertise	sb.fk.sg.ubest
illusion	sb.fk.sg.ubest
fjord	sb.fk.sg.ubest
embedsmand	sb.fk.sg.ubest
kuffert	sb.fk.sg.ubest
skifte	sb.itk.sg.ubest
vuggestue	sb.fk.sg.ubest
støv	sb.itk.sg.ubest
farvand	sb.itk.sg.ubest
tidsrum	sb.itk.sg.ubest
statsadvokat	sb.fk.sg.ubest
van	sb.fk.sg.ubest
hyldest	sb.fk.sg.ubest
vicedirektør	sb.fk.sg.ubest
fortov	sb.itk.sg.ubest
universitetshospital	sb.itk.sg.ubest
elefant	sb.fk.sg.ubest
japaner	sb.fk.sg.ubest
slægt	sb.fk.sg.ubest
boldklub	sb.fk.sg.ubest
kemi	sb.fk.sg.ubest
pot	sb.fk.sg.ubest
almindelighed	sb.fk.sg.ubest
hektar	sb.fk.sg.ubest
oberst	sb.fk.sg.ubest
minoritet	sb.fk.sg.ubest
register	sb.itk.sg.ubest
handlingsplan	sb.fk.sg.ubest
viking	sb.fk.sg.ubest
tillæg	sb.itk.sg.ubest
udebane	sb.fk.sg.ubest
diktatur	sb.itk.sg.ubest
duel	sb.fk.sg.ubest
rand	sb.fk.sg.ubest
skuffe	sb.fk.sg.ubest
forbryder	sb.fk.sg.ubest
handler	sb.fk.sg.ubest
fleksibilitet	sb.fk.sg.ubest
fætter	sb.fk.sg.ubest
gentagelse	sb.fk.sg.ubest
virus	sb.fk.sg.ubest
jura	sb.fk.sg.ubest
ishockey	sb.fk.sg.ubest
kendelse	sb.fk.sg.ubest
kommunisme	sb.fk.sg.ubest
hale	sb.fk.sg.ubest
prisstigning	sb.fk.sg.ubest
asfalt	sb.fk.sg.ubest
omdrejningspunkt	sb.itk.sg.ubest
afvikling	sb.fk.sg.ubest
kind	sb.fk.sg.ubest
opsving	sb.itk.sg.ubest
frø	sb.itk.sg.ubest
psykologi	sb.fk.sg.ubest
orientering	sb.fk.sg.ubest
dukke	sb.fk.sg.ubest
polak	sb.fk.sg.ubest
lokalsamfund	sb.itk.sg.ubest
mormor	sb.fk.sg.ubest
skub	sb.itk.sg.ubest
ensomhed	sb.fk.sg.ubest
levetid	sb.fk.sg.ubest
landsplan	sb.itk.sg.ubest
civilisation	sb.fk.sg.ubest
sammensætning	sb.fk.sg.ubest
bedsteforælder	sb.fk.sg.ubest
magthaver	sb.fk.sg.ubest
knægt	sb.fk.sg.ubest
højre	sb.itk.sg.ubest
forspring	sb.itk.sg.ubest
tromme	sb.fk.sg.ubest
bivirkning	sb.fk.sg.ubest
ensemble	sb.itk.sg.ubest
ødelæggelse	sb.fk.sg.ubest
puls	sb.fk.sg.ubest
instans	sb.fk.sg.ubest
kvist	sb.fk.sg.ubest
storebror	sb.fk.sg.ubest
politimand	sb.fk.sg.ubest
dyrlæge	sb.fk.sg.ubest
opfindelse	sb.fk.sg.ubest
dal	sb.fk.sg.ubest
massakre	sb.fk.sg.ubest
fodboldklub	sb.fk.sg.ubest
udkant	sb.fk.sg.ubest
vedtagelse	sb.fk.sg.ubest
udnævnelse	sb.fk.sg.ubest
lugt	sb.fk.sg.ubest
bureaukrati	sb.itk.sg.ubest
skinne	sb.fk.sg.ubest
partnerskab	sb.itk.sg.ubest
vismand	sb.fk.sg.ubest
hjælper	sb.fk.sg.ubest
personbil	sb.fk.sg.ubest
narkoman	sb.fk.sg.ubest
kloster	sb.itk.sg.ubest
uafhængighed	sb.fk.sg.ubest
korn	sb.itk.sg.ubest
tilhører	sb.fk.sg.ubest
brandvæsen	sb.itk.sg.ubest
kro	sb.fk.sg.ubest
seddel	sb.fk.sg.ubest
lektie	sb.fk.sg.ubest
hvidløg	sb.itk.sg.ubest
afbud	sb.itk.sg.ubest
udviklingsland	sb.itk.sg.ubest
seksualitet	sb.fk.sg.ubest
datid	sb.fk.sg.ubest
diesel	sb.fk.sg.ubest
temperament	sb.itk.sg.ubest
ark	sb.itk.sg.ubest
afvisning	sb.fk.sg.ubest
kup	sb.itk.sg.ubest
ørken	sb.fk.sg.ubest
delegation	sb.fk.sg.ubest
gode	sb.itk.sg.ubest
socialrådgiver	sb.fk.sg.ubest
hævn	sb.fk.sg.ubest
midnat	sb.fk.sg.ubest
journal	sb.fk.sg.ubest
beskatning	sb.fk.sg.ubest
produktivitet	sb.fk.sg.ubest
tolerance	sb.fk.sg.ubest
høne	sb.fk.sg.ubest
kunstakademi	sb.itk.sg.ubest
besvær	sb.itk.sg.ubest
klemme	sb.fk.sg.ubest
orlov	sb.fk.sg.ubest
faglighed	sb.fk.sg.ubest
længsel	sb.fk.sg.ubest
koncernchef	sb.fk.sg.ubest
soveværelse	sb.itk.sg.ubest
force	sb.fk.sg.ubest
teskefuld	sb.fk.sg.ubest
procentpoint	sb.itk.sg.ubest
filial	sb.fk.sg.ubest
partileder	sb.fk.sg.ubest
deadline	sb.fk.sg.ubest
pil	sb.fk.sg.ubest
modtagelse	sb.fk.sg.ubest
monopol	sb.itk.sg.ubest
stål	sb.itk.sg.ubest
kul	sb.itk.sg.ubest
sammenlægning	sb.fk.sg.ubest
sagsbehandling	sb.fk.sg.ubest
hovedsæde	sb.itk.sg.ubest
dispensation	sb.fk.sg.ubest
svindel	sb.fk.sg.ubest
hygge	sb.fk.sg.ubest
sauce	sb.fk.sg.ubest
patent	sb.itk.sg.ubest
bokser	sb.fk.sg.ubest
horn	sb.itk.sg.ubest
sportsdirektør	sb.fk.sg.ubest
undertrykkelse	sb.fk.sg.ubest
midtbane	sb.fk.sg.ubest
knallert	sb.fk.sg.ubest
taktik	sb.fk.sg.ubest
maling	sb.fk.sg.ubest
bede	sb.fk.sg.ubest
atomvåben	sb.itk.sg.ubest
krog	sb.fk.sg.ubest
tænkning	sb.fk.sg.ubest
kommando	sb.fk.sg.ubest
rigspoliti	sb.itk.sg.ubest
spillested	sb.itk.sg.ubest
førtidspension	sb.fk.sg.ubest
bøsse	sb.fk.sg.ubest
pladeselskab	sb.itk.sg.ubest
pensionskasse	sb.fk.sg.ubest
drivkraft	sb.fk.sg.ubest
ulv	sb.fk.sg.ubest
anfører	sb.fk.sg.ubest
sammenhold	sb.itk.sg.ubest
skolegang	sb.fk.sg.ubest
udkast	sb.itk.sg.ubest
incitament	sb.itk.sg.ubest
bremse	sb.fk.sg.ubest
palads	sb.itk.sg.ubest
juleaften	sb.fk.sg.ubest
skær	sb.itk.sg.ubest
barriere	sb.fk.sg.ubest
julegave	sb.fk.sg.ubest
udflugt	sb.fk.sg.ubest
røv	sb.fk.sg.ubest
software	sb.fk.sg.ubest
drue	sb.fk.sg.ubest
illustration	sb.fk.sg.ubest
dynamik	sb.fk.sg.ubest
nøgletal	sb.itk.sg.ubest
handicap	sb.itk.sg.ubest
socialist	sb.fk.sg.ubest
bagmand	sb.fk.sg.ubest
registrering	sb.fk.sg.ubest
nationalmuseum	sb.itk.sg.ubest
uniform	sb.fk.sg.ubest
spejder	sb.fk.sg.ubest
udlægning	sb.fk.sg.ubest
julemand	sb.fk.sg.ubest
formidling	sb.fk.sg.ubest
kald	sb.itk.sg.ubest
kanon	sb.fk.sg.ubest
konkurs	sb.fk.sg.ubest
rotte	sb.fk.sg.ubest
organisme	sb.fk.sg.ubest
aids	sb.fk.sg.ubest
anstrengelse	sb.fk.sg.ubest
lejer	sb.fk.sg.ubest
milits	sb.fk.sg.ubest
forvirring	sb.fk.sg.ubest
essay	sb.itk.sg.ubest
dåse	sb.fk.sg.ubest
tegneserie	sb.fk.sg.ubest
trommeslager	sb.fk.sg.ubest
dessert	sb.fk.sg.ubest
fradrag	sb.itk.sg.ubest
reportage	sb.fk.sg.ubest
redning	sb.fk.sg.ubest
kapitalfond	sb.fk.sg.ubest
resolution	sb.fk.sg.ubest
domkirke	sb.fk.sg.ubest
tomme	sb.fk.sg.ubest
årsmøde	sb.itk.sg.ubest
perle	sb.fk.sg.ubest
våbenhvile	sb.fk.sg.ubest
bas	sb.fk.sg.ubest
charme	sb.fk.sg.ubest
indledning	sb.fk.sg.ubest
tobak	sb.fk.sg.ubest
argumentation	sb.fk.sg.ubest
kode	sb.fk.sg.ubest
forretningsmand	sb.fk.sg.ubest
kur	sb.fk.sg.ubest
dokumentarfilm	sb.fk.sg.ubest
skattestop	sb.itk.sg.ubest
talerstol	sb.fk.sg.ubest
mejeri	sb.itk.sg.ubest
søm	sb.itk.sg.ubest
sodavand	sb.fk.sg.ubest
kiosk	sb.fk.sg.ubest
tekniker	sb.fk.sg.ubest
færdighed	sb.fk.sg.ubest
efterkommer	sb.fk.sg.ubest
mikrofon	sb.fk.sg.ubest
attentat	sb.itk.sg.ubest
initiativtager	sb.fk.sg.ubest
lade	sb.fk.sg.ubest
rigdom	sb.fk.sg.ubest
power	sb.fk.sg.ubest
tolk	sb.fk.sg.ubest
kriger	sb.fk.sg.ubest
enke	sb.fk.sg.ubest
idiot	sb.fk.sg.ubest
bygherre	sb.fk.sg.ubest
levering	sb.fk.sg.ubest
elbil	sb.fk.sg.ubest
senator	sb.fk.sg.ubest
cykelsti	sb.fk.sg.ubest
vicepræsident	sb.fk.sg.ubest
logo	sb.fk.sg.ubest
kapitalisme	sb.fk.sg.ubest
mel	sb.itk.sg.ubest
punktum	sb.itk.sg.ubest
producer	sb.fk.sg.ubest
slogan	sb.itk.sg.ubest
panel	sb.itk.sg.ubest
sjov	sb.fk.sg.ubest
beliggenhed	sb.fk.sg.ubest
sejl	sb.itk.sg.ubest
cykelrytter	sb.fk.sg.ubest
fremgangsmåde	sb.fk.sg.ubest
menneskeliv	sb.itk.sg.ubest
tip	sb.fk.sg.ubest
sagsbehandler	sb.fk.sg.ubest
gymnastik	sb.fk.sg.ubest
præsidentkandidat	sb.fk.sg.ubest
socialminister	sb.fk.sg.ubest
kurder	sb.fk.sg.ubest
ærinde	sb.itk.sg.ubest
hovedstadsområde	sb.itk.sg.ubest
amatør	sb.fk.sg.ubest
boghandel	sb.fk.sg.ubest
mekanisme	sb.fk.sg.ubest
undergrund	sb.fk.sg.ubest
bagsæde	sb.itk.sg.ubest
straffe	sb.itk.sg.ubest
retsmøde	sb.itk.sg.ubest
udformning	sb.fk.sg.ubest
guvernør	sb.fk.sg.ubest
væld	sb.itk.sg.ubest
lønstigning	sb.fk.sg.ubest
årstid	sb.fk.sg.ubest
slik	sb.fk.sg.ubest
tvilling	sb.fk.sg.ubest
skurk	sb.fk.sg.ubest
kreditor	sb.fk.sg.ubest
senat	sb.itk.sg.ubest
oversvømmelse	sb.fk.sg.ubest
embede	sb.itk.sg.ubest
reference	sb.fk.sg.ubest
graviditet	sb.fk.sg.ubest
borgerrepræsentation	sb.fk.sg.ubest
tophold	sb.itk.sg.ubest
årsregnskab	sb.itk.sg.ubest
makker	sb.fk.sg.ubest
omstilling	sb.fk.sg.ubest
tysk	sb.itk.sg.ubest
græker	sb.fk.sg.ubest
middelklasse	sb.fk.sg.ubest
problematik	sb.fk.sg.ubest
ondskab	sb.fk.sg.ubest
rede	sb.fk.sg.ubest
høj	sb.fk.sg.ubest
korrespondent	sb.fk.sg.ubest
gåde	sb.fk.sg.ubest
livskvalitet	sb.fk.sg.ubest
kantine	sb.fk.sg.ubest
psykiatri	sb.fk.sg.ubest
skind	sb.itk.sg.ubest
kredit	sb.fk.sg.ubest
klubhus	sb.itk.sg.ubest
organist	sb.fk.sg.ubest
grill	sb.fk.sg.ubest
ritual	sb.itk.sg.ubest
spidskandidat	sb.fk.sg.ubest
plejecenter	sb.itk.sg.ubest
naturgas	sb.fk.sg.ubest
spark	sb.itk.sg.ubest
luksus	sb.fk.sg.ubest
gigant	sb.fk.sg.ubest
kulturliv	sb.itk.sg.ubest
hjemmekamp	sb.fk.sg.ubest
ejerskab	sb.itk.sg.ubest
koloni	sb.fk.sg.ubest
forhindring	sb.fk.sg.ubest
dramatiker	sb.fk.sg.ubest
legat	sb.fk.sg.ubest
vaccine	sb.fk.sg.ubest
erhvervsminister	sb.fk.sg.ubest
event	sb.fk.sg.ubest
guldmedalje	sb.fk.sg.ubest
straffespark	sb.itk.sg.ubest
ski	sb.fk.sg.ubest
protein	sb.itk.sg.ubest
medejer	sb.fk.sg.ubest
læring	sb.fk.sg.ubest
byrde	sb.fk.sg.ubest
privathospital	sb.itk.sg.ubest
snor	sb.fk.sg.ubest
introduktion	sb.fk.sg.ubest
søgelys	sb.itk.sg.ubest
slutspil	sb.itk.sg.ubest
jakkesæt	sb.itk.sg.ubest
passion	sb.fk.sg.ubest
optakt	sb.fk.sg.ubest
tilsagn	sb.itk.sg.ubest
forhåbning	sb.fk.sg.ubest
statsobligation	sb.fk.sg.ubest
kurv	sb.fk.sg.ubest
parforhold	sb.itk.sg.ubest
indrømmelse	sb.fk.sg.ubest
tiltale	sb.fk.sg.ubest
ikon	sb.fk.sg.ubest
garage	sb.fk.sg.ubest
akt	sb.fk.sg.ubest
reporter	sb.fk.sg.ubest
nazisme	sb.fk.sg.ubest
salme	sb.fk.sg.ubest
underdirektør	sb.fk.sg.ubest
sekretariat	sb.itk.sg.ubest
nisse	sb.fk.sg.ubest
dej	sb.fk.sg.ubest
sangskriver	sb.fk.sg.ubest
dramatik	sb.fk.sg.ubest
spillefilm	sb.fk.sg.ubest
ed	sb.fk.sg.ubest
parcelhus	sb.itk.sg.ubest
trivsel	sb.fk.sg.ubest
skema	sb.itk.sg.ubest
krænkelse	sb.fk.sg.ubest
fodboldkamp	sb.fk.sg.ubest
vitamin	sb.itk.sg.ubest
trick	sb.itk.sg.ubest
tabel	sb.fk.sg.ubest
kraftværk	sb.itk.sg.ubest
kompagni	sb.itk.sg.ubest
opsigt	sb.fk.sg.ubest
arkæolog	sb.fk.sg.ubest
larm	sb.fk.sg.ubest
scenarie	sb.itk.sg.ubest
tegnestue	sb.fk.sg.ubest
violin	sb.fk.sg.ubest
zoo	sb.fk.sg.ubest
vidende	sb.itk.sg.ubest
blodprop	sb.fk.sg.ubest
afklaring	sb.fk.sg.ubest
straffelov	sb.fk.sg.ubest
svigt	sb.itk.sg.ubest
kostume	sb.itk.sg.ubest
overvægt	sb.fk.sg.ubest
bassist	sb.fk.sg.ubest
campingplads	sb.fk.sg.ubest
studentereksamen	sb.fk.sg.ubest
utal	sb.itk.sg.ubest
kvartet	sb.fk.sg.ubest
foranstaltning	sb.fk.sg.ubest
spilleregel	sb.fk.sg.ubest
paradoks	sb.itk.sg.ubest
samtid	sb.fk.sg.ubest
hytte	sb.fk.sg.ubest
destination	sb.fk.sg.ubest
junior	sb.fk.sg.ubest
tilbehør	sb.itk.sg.ubest
knogle	sb.fk.sg.ubest
mini	sb.fk.sg.ubest
regnestykke	sb.itk.sg.ubest
dansk	sb.itk.sg.ubest
orkan	sb.fk.sg.ubest
bedrageri	sb.itk.sg.ubest
franskmand	sb.fk.sg.ubest
atlet	sb.fk.sg.ubest
dråbe	sb.fk.sg.ubest
prioritet	sb.fk.sg.ubest
rejsebureau	sb.itk.sg.ubest
bebyggelse	sb.fk.sg.ubest
betjening	sb.fk.sg.ubest
olivenolie	sb.fk.sg.ubest
stod	sb.itk.sg.ubest
realkredit	sb.fk.sg.ubest
bedømmelse	sb.fk.sg.ubest
lort	sb.fk.sg.ubest
henseende	sb.fk.sg.ubest
modernisering	sb.fk.sg.ubest
attitude	sb.fk.sg.ubest
retssikkerhed	sb.fk.sg.ubest
es	sb.itk.sg.ubest
indspilning	sb.fk.sg.ubest
styk	sb.itk.sg.ubest
verdensplan	sb.itk.sg.ubest
observation	sb.fk.sg.ubest
araber	sb.fk.sg.ubest
støvle	sb.fk.sg.ubest
saft	sb.fk.sg.ubest
skoleelev	sb.fk.sg.ubest
værdighed	sb.fk.sg.ubest
tilbagetrækning	sb.fk.sg.ubest
departementschef	sb.fk.sg.ubest
klippe	sb.fk.sg.ubest
knap	sb.fk.sg.ubest
skoleår	sb.itk.sg.ubest
ironi	sb.fk.sg.ubest
sidelinje	sb.fk.sg.ubest
prostitution	sb.fk.sg.ubest
database	sb.fk.sg.ubest
økologi	sb.fk.sg.ubest
diskrimination	sb.fk.sg.ubest
intelligens	sb.fk.sg.ubest
forsyning	sb.fk.sg.ubest
fejltagelse	sb.fk.sg.ubest
jyde	sb.fk.sg.ubest
importør	sb.fk.sg.ubest
udsyn	sb.itk.sg.ubest
beton	sb.fk.sg.ubest
eng	sb.fk.sg.ubest
ocean	sb.itk.sg.ubest
opdragelse	sb.fk.sg.ubest
oversigt	sb.fk.sg.ubest
efternavn	sb.itk.sg.ubest
komposition	sb.fk.sg.ubest
rædsel	sb.fk.sg.ubest
krydderi	sb.itk.sg.ubest
diabetes	sb.fk.sg.ubest
missil	sb.itk.sg.ubest
opkald	sb.itk.sg.ubest
blues	sb.fk.sg.ubest
elektronik	sb.fk.sg.ubest
digtsamling	sb.fk.sg.ubest
satire	sb.fk.sg.ubest
dankort	sb.itk.sg.ubest
pung	sb.fk.sg.ubest
rig	sb.fk.sg.ubest
flyvning	sb.fk.sg.ubest
kommunistparti	sb.itk.sg.ubest
klang	sb.fk.sg.ubest
husejer	sb.fk.sg.ubest
privatisering	sb.fk.sg.ubest
patrulje	sb.fk.sg.ubest
kommunaldirektør	sb.fk.sg.ubest
mobning	sb.fk.sg.ubest
told	sb.fk.sg.ubest
banegård	sb.fk.sg.ubest
jungle	sb.fk.sg.ubest
aldersgruppe	sb.fk.sg.ubest
savn	sb.itk.sg.ubest
dække	sb.itk.sg.ubest
isolation	sb.fk.sg.ubest
væske	sb.fk.sg.ubest
politistation	sb.fk.sg.ubest
intensitet	sb.fk.sg.ubest
albaner	sb.fk.sg.ubest
hyld	sb.fk.sg.ubest
spiritus	sb.fk.sg.ubest
pære	sb.fk.sg.ubest
bræt	sb.itk.sg.ubest
kokain	sb.fk.sg.ubest
skak	sb.fk.sg.ubest
stab	sb.fk.sg.ubest
klarhed	sb.fk.sg.ubest
bamse	sb.fk.sg.ubest
debattør	sb.fk.sg.ubest
høst	sb.fk.sg.ubest
bruttonationalprodukt	sb.itk.sg.ubest
bestseller	sb.fk.sg.ubest
holm	sb.fk.sg.ubest
hoppe	sb.fk.sg.ubest
mindeord	sb.itk.sg.ubest
afgrøde	sb.fk.sg.ubest
chip	sb.fk.sg.ubest
pynt	sb.fk.sg.ubest
potential	sb.itk.sg.ubest
nummerplade	sb.fk.sg.ubest
mærkesag	sb.fk.sg.ubest
mægler	sb.fk.sg.ubest
bo	sb.itk.sg.ubest
fuldmægtig	sb.fk.sg.ubest
lidenskab	sb.fk.sg.ubest
bær	sb.itk.sg.ubest
kabel	sb.itk.sg.ubest
skæg	sb.fk.sg.ubest
biolog	sb.fk.sg.ubest
insekt	sb.itk.sg.ubest
reol	sb.fk.sg.ubest
naturvidenskab	sb.fk.sg.ubest
brugerbetaling	sb.fk.sg.ubest
hjemmehjælp	sb.fk.sg.ubest
røst	sb.fk.sg.ubest
lederskab	sb.itk.sg.ubest
fredsaftale	sb.fk.sg.ubest
jern	sb.itk.sg.ubest
udbyder	sb.fk.sg.ubest
syre	sb.fk.sg.ubest
rækkefølge	sb.fk.sg.ubest
tavle	sb.fk.sg.ubest
standpunkt	sb.itk.sg.ubest
camp	sb.fk.sg.ubest
tempel	sb.itk.sg.ubest
skel	sb.itk.sg.ubest
nytte	sb.fk.sg.ubest
indianer	sb.fk.sg.ubest
splittelse	sb.fk.sg.ubest
citron	sb.fk.sg.ubest
factor	sb.fk.sg.ubest
seminar	sb.itk.sg.ubest
fængselsstraf	sb.fk.sg.ubest
substans	sb.fk.sg.ubest
dragt	sb.fk.sg.ubest
ægtemand	sb.fk.sg.ubest
midtby	sb.fk.sg.ubest
mødested	sb.itk.sg.ubest
frisør	sb.fk.sg.ubest
bjørn	sb.fk.sg.ubest
nationalpark	sb.fk.sg.ubest
kaserne	sb.fk.sg.ubest
slave	sb.fk.sg.ubest
billedkunst	sb.fk.sg.ubest
foretagende	sb.itk.sg.ubest
husholdning	sb.fk.sg.ubest
musikskole	sb.fk.sg.ubest
eftertanke	sb.fk.sg.ubest
afskaffelse	sb.fk.sg.ubest
mesterværk	sb.itk.sg.ubest
hindring	sb.fk.sg.ubest
campingvogn	sb.fk.sg.ubest
dagpleje	sb.fk.sg.ubest
skolelærer	sb.fk.sg.ubest
svømning	sb.fk.sg.ubest
ugeblad	sb.itk.sg.ubest
boss	sb.fk.sg.ubest
moment	sb.itk.sg.ubest
ny	sb.itk.sg.ubest
elsker	sb.fk.sg.ubest
befrielse	sb.fk.sg.ubest
kiste	sb.fk.sg.ubest
vrøvl	sb.itk.sg.ubest
bager	sb.fk.sg.ubest
takst	sb.fk.sg.ubest
gran	sb.fk.sg.ubest
jury	sb.fk.sg.ubest
kapel	sb.itk.sg.ubest
bestilling	sb.fk.sg.ubest
lunge	sb.fk.sg.ubest
skik	sb.fk.sg.ubest
spild	sb.itk.sg.ubest
gate	sb.fk.sg.ubest
iver	sb.fk.sg.ubest
reparation	sb.fk.sg.ubest
sportsgren	sb.fk.sg.ubest
topskat	sb.fk.sg.ubest
nærvær	sb.itk.sg.ubest
mistillid	sb.fk.sg.ubest
beslutningsforslag	sb.itk.sg.ubest
disk	sb.fk.sg.ubest
magi	sb.fk.sg.ubest
radioavis	sb.fk.sg.ubest
arbejdsstyrke	sb.fk.sg.ubest
begynder	sb.fk.sg.ubest
indblanding	sb.fk.sg.ubest
byggeplads	sb.fk.sg.ubest
harmoni	sb.fk.sg.ubest
folkepension	sb.fk.sg.ubest
kommunalreform	sb.fk.sg.ubest
chefkonsulent	sb.fk.sg.ubest
grus	sb.itk.sg.ubest
appetit	sb.fk.sg.ubest
fædreland	sb.itk.sg.ubest
parlamentariker	sb.fk.sg.ubest
udsving	sb.itk.sg.ubest
hug	sb.itk.sg.ubest
skænderi	sb.itk.sg.ubest
lodtrækning	sb.fk.sg.ubest
madpakke	sb.fk.sg.ubest
vifte	sb.fk.sg.ubest
monument	sb.itk.sg.ubest
flade	sb.fk.sg.ubest
udveksling	sb.fk.sg.ubest
vask	sb.fk.sg.ubest
søværn	sb.itk.sg.ubest
nybyggeri	sb.itk.sg.ubest
drink	sb.fk.sg.ubest
julefrokost	sb.fk.sg.ubest
workshop	sb.fk.sg.ubest
hvidvin	sb.fk.sg.ubest
afskedigelse	sb.fk.sg.ubest
pædagogik	sb.fk.sg.ubest
psykiater	sb.fk.sg.ubest
kæft	sb.fk.sg.ubest
telefonnummer	sb.itk.sg.ubest
trumf	sb.fk.sg.ubest
sejler	sb.fk.sg.ubest
kollektion	sb.fk.sg.ubest
bøf	sb.fk.sg.ubest
stormagt	sb.fk.sg.ubest
timing	sb.fk.sg.ubest
sygefravær	sb.itk.sg.ubest
tolkning	sb.fk.sg.ubest
statue	sb.fk.sg.ubest
gardin	sb.itk.sg.ubest
aktindsigt	sb.fk.sg.ubest
kulturarv	sb.fk.sg.ubest
mafia	sb.fk.sg.ubest
hule	sb.fk.sg.ubest
fyrværkeri	sb.itk.sg.ubest
pagt	sb.fk.sg.ubest
pizza	sb.fk.sg.ubest
fascination	sb.fk.sg.ubest
hierarki	sb.itk.sg.ubest
opfyldelse	sb.fk.sg.ubest
bue	sb.fk.sg.ubest
aflevering	sb.fk.sg.ubest
statsstøtte	sb.fk.sg.ubest
grundlægger	sb.fk.sg.ubest
realisme	sb.fk.sg.ubest
præcision	sb.fk.sg.ubest
skattevæsen	sb.itk.sg.ubest
føde	sb.fk.sg.ubest
master	sb.fk.sg.ubest
fortsættelse	sb.fk.sg.ubest
tvang	sb.fk.sg.ubest
skytte	sb.fk.sg.ubest
suverænitet	sb.fk.sg.ubest
ledning	sb.fk.sg.ubest
nedskrivning	sb.fk.sg.ubest
dosis	sb.fk.sg.ubest
frost	sb.fk.sg.ubest
billedhugger	sb.fk.sg.ubest
verdensmesterskab	sb.itk.sg.ubest
march	sb.fk.sg.ubest
foredragsholder	sb.fk.sg.ubest
guardian	sb.fk.sg.ubest
kurator	sb.fk.sg.ubest
prestige	sb.fk.sg.ubest
kabine	sb.fk.sg.ubest
spand	sb.itk.sg.ubest
flis	sb.fk.sg.ubest
maske	sb.fk.sg.ubest
cocktail	sb.fk.sg.ubest
motto	sb.itk.sg.ubest
propaganda	sb.fk.sg.ubest
trængsel	sb.fk.sg.ubest
trafikminister	sb.fk.sg.ubest
computerspil	sb.itk.sg.ubest
hop	sb.itk.sg.ubest
vikar	sb.fk.sg.ubest
afhængighed	sb.fk.sg.ubest
servering	sb.fk.sg.ubest
forargelse	sb.fk.sg.ubest
trøst	sb.fk.sg.ubest
hovedgade	sb.fk.sg.ubest
recession	sb.fk.sg.ubest
diamant	sb.fk.sg.ubest
slips	sb.itk.sg.ubest
hjemby	sb.fk.sg.ubest
satellit	sb.fk.sg.ubest
bælt	sb.itk.sg.ubest
oplag	sb.itk.sg.ubest
atletik	sb.fk.sg.ubest
sund	sb.itk.sg.ubest
grøft	sb.fk.sg.ubest
kanin	sb.fk.sg.ubest
thriller	sb.fk.sg.ubest
cykelløb	sb.itk.sg.ubest
bredde	sb.fk.sg.ubest
golfbane	sb.fk.sg.ubest
nationalitet	sb.fk.sg.ubest
objekt	sb.itk.sg.ubest
sociolog	sb.fk.sg.ubest
infektion	sb.fk.sg.ubest
elektricitet	sb.fk.sg.ubest
nordmand	sb.fk.sg.ubest
bagagerum	sb.itk.sg.ubest
dyne	sb.fk.sg.ubest
gågade	sb.fk.sg.ubest
opgang	sb.fk.sg.ubest
aftensmad	sb.fk.sg.ubest
loyalitet	sb.fk.sg.ubest
påbud	sb.itk.sg.ubest
praktik	sb.fk.sg.ubest
hede	sb.fk.sg.ubest
udslag	sb.itk.sg.ubest
dokumentar	sb.fk.sg.ubest
omhu	sb.fk.sg.ubest
flue	sb.fk.sg.ubest
manøvre	sb.fk.sg.ubest
vandløb	sb.itk.sg.ubest
spøgelse	sb.itk.sg.ubest
jomfru	sb.fk.sg.ubest
lad	sb.itk.sg.ubest
medborger	sb.fk.sg.ubest
biologi	sb.fk.sg.ubest
tarm	sb.fk.sg.ubest
fjer	sb.fk.sg.ubest
næring	sb.fk.sg.ubest
boble	sb.fk.sg.ubest
bolle	sb.fk.sg.ubest
statskundskab	sb.fk.sg.ubest
fane	sb.fk.sg.ubest
hobby	sb.fk.sg.ubest
sæde	sb.itk.sg.ubest
censur	sb.fk.sg.ubest
ridder	sb.fk.sg.ubest
bestand	sb.fk.sg.ubest
gensyn	sb.itk.sg.ubest
hjelm	sb.fk.sg.ubest
samler	sb.fk.sg.ubest
pels	sb.fk.sg.ubest
broderskab	sb.itk.sg.ubest
kommunikationschef	sb.fk.sg.ubest
score	sb.fk.sg.ubest
dødsstraf	sb.fk.sg.ubest
fløde	sb.fk.sg.ubest
brygge	sb.fk.sg.ubest
landsmand	sb.fk.sg.ubest
honorar	sb.itk.sg.ubest
spredning	sb.fk.sg.ubest
cup	sb.fk.sg.ubest
fælde	sb.fk.sg.ubest
hast	sb.fk.sg.ubest
styrkelse	sb.fk.sg.ubest
referat	sb.itk.sg.ubest
varemærke	sb.itk.sg.ubest
pen	sb.fk.sg.ubest
slægtning	sb.fk.sg.ubest
rundvisning	sb.fk.sg.ubest
skød	sb.itk.sg.ubest
bankdirektør	sb.fk.sg.ubest
deling	sb.fk.sg.ubest
tænker	sb.fk.sg.ubest
boykot	sb.fk.sg.ubest
skuespillerinde	sb.fk.sg.ubest
æstetik	sb.fk.sg.ubest
postkasse	sb.fk.sg.ubest
halvø	sb.fk.sg.ubest
detailhandel	sb.fk.sg.ubest
passer	sb.fk.sg.ubest
gennemførelse	sb.fk.sg.ubest
house	sb.fk.sg.ubest
teolog	sb.fk.sg.ubest
borgerforening	sb.fk.sg.ubest
broder	sb.fk.sg.ubest
kulturudvalg	sb.itk.sg.ubest
ældrepleje	sb.fk.sg.ubest
forvandling	sb.fk.sg.ubest
roma	sb.fk.sg.ubest
vandring	sb.fk.sg.ubest
tilpasning	sb.fk.sg.ubest
aktivering	sb.fk.sg.ubest
skræk	sb.fk.sg.ubest
attraktion	sb.fk.sg.ubest
frimærke	sb.itk.sg.ubest
hofte	sb.fk.sg.ubest
romantik	sb.fk.sg.ubest
overførselsindkomst	sb.fk.sg.ubest
bekendtgørelse	sb.fk.sg.ubest
anmodning	sb.fk.sg.ubest
nytænkning	sb.fk.sg.ubest
lancering	sb.fk.sg.ubest
torsk	sb.fk.sg.ubest
indvielse	sb.fk.sg.ubest
medhold	sb.itk.sg.ubest
socialisme	sb.fk.sg.ubest
bytte	sb.itk.sg.ubest
hovedret	sb.fk.sg.ubest
genopbygning	sb.fk.sg.ubest
abonnement	sb.itk.sg.ubest
taxi	sb.fk.sg.ubest
fødevareminister	sb.fk.sg.ubest
indbrudstyv	sb.fk.sg.ubest
alkoholiker	sb.fk.sg.ubest
